
/articles/speeches-steve-jobs-apple-stanford/	war-and-peace
/articles/immigration-primer/	law
/articles/bio-world-leaders-caesar-augustus/	war-and-peace
/articles/park-service-trump/	law
/articles/lib-history-gladiator-roman-games/	war-and-peace
/articles/lib-nasa-northern-lights-aurora-borealis/	war-and-peace
/articles/john-lewis-book-award/	kids
/articles/loc-mysteries-cats-purr/	science
/articles/immigration-executive-order/	law
/articles/droneboarding-latvia/	sports
/articles/lib-nasa-clouds/	war-and-peace
/articles/baseball-jet-lag/	sports
/articles/lib-history-chinese-new-year-traditions/	arts
/articles/badger-otter-teeth/	science
/articles/myths-stars-constellations/	arts
/articles/hatchimals-lawsuit/	kids
/articles/lib-history-chinese-new-year/	arts
/articles/lib-nasa-habitable-worlds-exoplanets/	war-and-peace
/articles/alien-air-exoplanet/	science
/articles/ohio-town-voters/	law
/articles/BHP-east-asia-geo-korea-japan/	war-and-peace
/articles/dogs-memory/	science
/articles/BHP-east-asia-geo-china/	war-and-peace
/articles/smi-history-protests-washington/	war-and-peace
/articles/lib-history-ancient-greece-democracy/	law
/articles/falcons-patriots-superbowl/	sports
/articles/cattle-skittle-spill/	money
/articles/speeches-pericles-funeral-oration/	war-and-peace
/articles/loc-mysteries-stone-skip-water/	science
/articles/cold-weather-alaska/	science
/articles/brain-cells-GPS/	science
/articles/myths-pegasus-bellerophon/	arts
/articles/smi-byzantine-empire-circus/	war-and-peace
/articles/womens-marches/	law
/articles/kids-white-house/	kids
/articles/loc-mysteries-bats/	science
/articles/planets-rogue-one/	science
/articles/lib-procon-vaccines/	science
/articles/afghan-women-orchestra/	arts
/articles/speeches-trump-inauguration/	war-and-peace
/articles/loc-mysteries-spider-web-tangle/	science
/articles/trump-inauguration/	law
/articles/lib-history-ancient-rome-empire/	war-and-peace
/articles/self-driving-cars-safety/	science
/articles/venomous-animals-australia/	science
/articles/lib-history-ancient-rome-kingdom-republic/	war-and-peace
/articles/spearers-welcoming-youth/	kids
/articles/loc-mysteries-moth-butterfly/	science
/articles/counting-crowds-inauguration/	law
/articles/lib-history-mexico-independence/	war-and-peace
/articles/gl-history-clinton-presidency/	law
/articles/discrimination-native-americans/	law
/articles/primary-source-george-washington-farewell/	war-and-peace
/articles/united-states-climate-threshold/	science
/articles/endangered-bumblebee/	science
/articles/govt-job-president/	law
/articles/lib-history-ancient-greece/	war-and-peace
/articles/gene-cernan-obit/	science
/articles/gl-history-bush-presidency/	law
/articles/baboons-speech-vowels/	science
/articles/ski-resort-snow/	sports
/articles/dream-job-microbial-ecologist/	science
/articles/family-birthdays-probability/	kids
/articles/lib-history-presidential-inauguration/	law
/articles/myths-midas-donkey-ears/	arts
/articles/Daliyah-1000-books/	kids
/articles/loc-mysteries-strongest-muscle/	science
/articles/ringling-bros-circus/	money
/articles/dream-job-planetary-geologist/	science
/articles/snow-leopard-sanctuary/	science
/articles/Arizona-dark-skies/	science
/articles/lib-history-samurai-bushido/	war-and-peace
/articles/myths-midas-gold/	war-and-peace
/articles/gl-history-seventies/	war-and-peace
/articles/animal-flatulence/	science
/articles/obama-monuments-civil-rights/	law
/articles/loc-mysteries-rain-objects/	science
/articles/secret-life-snowflakes/	science
/articles/super-bowl-be-player/	sports
/articles/govt-mlk-memphis-sanitation/	law
/articles/loc-mysteries-static-electricity/	science
/articles/remembering-historic-giant-tree/	science
/articles/student-art-ferguson-congressman/	arts
/articles/smi-journalists-hitler-mussolini/	war-and-peace
/articles/dream-job-make-up-artist/	arts
/articles/drones-hospital-supplies/	health
/articles/roof-sentencing/	law
/articles/speeches-obama-farewell/	law
/articles/lib-history-selma-to-montgomery/	law
/articles/obama-farewell/	law
/articles/avalanche-control-big-guns/	science
/articles/gl-history-sixties/	war-and-peace
/articles/students-fake-news/	kids
/articles/gl-history-counterculture/	law
/articles/gabrielino-tongva-artist-native-american/	arts
/articles/essay-fake-news-history/	law
/articles/lib-history-invention-internet/	science
/articles/listening-home-tech/	law
/articles/primary-source-thoreau-walden-conclusion/	arts
/articles/lib-history-montgomery-bus-boycott/	law
/articles/inauguration-dilemma/	law
/articles/hungry-planet-fish-farms/	science
/articles/exercise-risk-warriors/	health
/articles/myths-odysseus-odyssey-simple/	arts
/articles/dream-job-atmospheric-chemist/	science
/articles/primary-source-thoreau-walden-where/	law
/articles/michelle-obama-final-speech/	kids
/articles/fake-news-history-teachers/	kids
/articles/gl-history-1945-present-affulent-society/	law
/articles/peanut-allergies/	health
/articles/skiers-lynx-sighting/	science
/articles/primary-source-einstein-fdr-nuclear/	war-and-peace
/articles/lib-nasa-blanket-around-earth/	science
/articles/nasa-new-missions/	science
/articles/gl-history-1945-present-mccarthy/	law
/articles/japan-owl-cafes/	law
/articles/dream-job-dementia-consultant/	health
/articles/fake-news-money/	money
/articles/human-plague-US/	health
/articles/govt-what-is-gps/	science
/articles/turtles-ancient-journey/	science
/articles/gl-history-wwII-dday-end-war/	war-and-peace
/articles/mystery-radio-burst/	science
/articles/dream-job-stunt-performer/	arts
/articles/Historic-Black-Schoolhouse/	law
/articles/BHP-9-China-Divergence/	war-and-peace
/articles/rural-communities-gathering-spots/	money
/articles/loc-mysteries-roller-coaster/	science
/articles/dream-job-robotics/	science
/articles/primary-source-titanic-telegraph/	law
/articles/leap-seconds-2017/	science
/articles/gl-history-wwII-battlefield/	war-and-peace
/articles/gabby-douglas-online-bullying/	sports
/articles/3d-hand-fifth-grader/	kids
/articles/tourists-egypt-culture/	war-and-peace
/articles/gl-history-us-enters-ww-II/	war-and-peace
/articles/dream-job-thermal-systems-engineer/	science
/articles/kids-suing-state/	kids
/articles/vera-rubin-death/	science
/articles/primary-source-ben-franklin-kite-electricity/	science
/articles/overview-e-cigarettes/	health
/articles/obama-fish/	science
/articles/dog-cost/	money
/articles/gl-history-origins-ww-II/	war-and-peace
/articles/abe-obama-pearl-harbor/	war-and-peace
/articles/myths-halcyon-birds/	war-and-peace
/articles/govt-how-laws-made/	law
/articles/bug-on-my-plate/	science
/articles/dream-job-flight-attendant/	science
/articles/baseball-pace/	opinion
/articles/ipads-schools/	kids
/articles/offshore-drilling-protections/	science
/articles/primary-source-jefferson-religious-freedom/	law
/articles/kids-junk-food-ads/	health
/articles/dream-job-ice-cream-maker/	opinion
/articles/govt-black-soldiers-civil-war/	war-and-peace
/articles/2016-word-of-year/	arts
/articles/mexico-firework-accident/	science
/articles/loc-mysteries-yawning/	science
/articles/loc-mysteries-coconuts/	science
/articles/inauguration-cost/	law
/articles/dream-job-physicist/	science
/articles/issue-overview-golf-sport/	sports
/articles/yupik-sea-ice-warming/	science
/articles/obama-pardons/	law
/articles/BHP-8-centralsouthafrica/	war-and-peace
/articles/vaquita-porpoise-protection/	science
/articles/lib-nasa-four-forces-on-rocket/	science
/articles/dolls-diversity/	kids
/articles/primary-source-new-deal-ccc/	war-and-peace
/articles/trump-electoral-college-victory/	law
/articles/smi-henrietta-lacks-immortal-cells/	science
/articles/seahorses-weird/	science
/articles/dream-job-forth-bridge-painter/	arts
/articles/talking-cars/	law
/articles/gl-history-new-deal/	war-and-peace
/articles/berlin-truck-crash-christmas-market/	war-and-peace
/articles/dream-job-hotel-manager/	opinion
/articles/primary-sources-henry-ford-change/	science
/articles/video-games-exercise/	health
/articles/govt-history-white-house/	law
/articles/squirrels-christmas/	science
/articles/brothers-keeper-life/	law
/articles/dream-job-special-effects-animator/	arts
/articles/lib-nasa-climate-and-climate-change/	science
/articles/primary-source-ben-franklin-autobiography/	law
/articles/gl-history-great-depression-essay/	war-and-peace
/articles/robot-delivery-cities/	science
/articles/students-computer-usage/	kids
/articles/blind-driverless-car/	health
/articles/opinion-political-boycotts/	law
/articles/lib-nasa-black-holes/	science
/articles/historic-news-hanukkah-assimilation/	law
/articles/overview-painkillers-heroin-addiction/	health
/articles/aleppo-war-evacuation/	war-and-peace
/articles/dream-job-hairdresser/	arts
/articles/sorting-hat-spider/	science
/articles/winter-weather-2016/	money
/articles/starwars-rogue-one/	arts
/articles/lib-nasa-polar-vortex/	science
/articles/lunch-cheese-sandwich/	kids
/articles/lib-nasa-water-cycle/	science
/articles/spy-museum-autism-access/	kids
/articles/gl-history-roaring-twenties/	war-and-peace
/articles/highschool-concussions-tx/	sports
/articles/dream-job-flight-director/	science
/articles/france-rats/	health
/articles/lib-history-new-years-eve/	arts
/articles/primary-source-hamilton-federalist-electoral/	law
/articles/sd-pipeline-whats-next/	law
/articles/dream-job-systems-engineer/	science
/articles/muslim-restaurant-christmas/	money
/articles/giraffe-silent-extinction/	science
/articles/bio-authors-toni-morrison/	arts
/articles/life-expectancy-2016/	health
/articles/lib-nasa-orbit/	science
/articles/lib-nasa-apollo-program/	science
/articles/python-big-gulp/	science
/articles/lib-nasa-snowflakes/	science
/articles/bosnia-swim-club/	kids
/articles/dream-job-summer-research-student/	science
/articles/mozart-disease-mystery/	arts
/articles/volunteers-voice-bank/	science
/articles/dream-job-astronaut/	science
/articles/john-glenn-obit/	science
/articles/lib-nasa-why-sky-is-blue/	science
/articles/govt-science-wildfires/	science
/articles/cellphones-in-school/	kids
/articles/bio-artists-pablo-picasso/	arts
/articles/fake-news-ramifications/	law
/articles/oldest-rocks-solar-system/	science
/articles/salto-the-jumping-robot/	science
/articles/lib-history-christmas/	arts
/articles/lib-history-hanukkah/	arts
/articles/gl-history-world-war-I/	war-and-peace
/articles/harper-lee-hometown/	arts
/articles/lib-history-kwanzaa/	arts
/articles/texas-pe-program/	sports
/articles/egypt-queen/	arts
/articles/smi-history-christmas-lights/	arts
/articles/santa-images-school/	kids
/articles/smi-history-house-cats/	science
/articles/LA-metro-elephant-fossil/	science
/articles/lib-nasa-origin-and-destiny-of-universe/	science
/articles/Police-Shooting-North-Charleston/	law
/articles/dream-job-planetary-geophysicist/	science
/articles/no-needle-vaccines/	health
/articles/govt-checks-balances/	law
/articles/bio-women-leaders-clara-barton/	health
/articles/shinzo-abe-pearl-harbor/	war-and-peace
/articles/pearl-harbor-mail-plane/	war-and-peace
/articles/dream-job-personal-trainer/	health
/articles/gl-history-gilded-age/	war-and-peace
/articles/spain-bullfighting/	law
/articles/periodic-table-new-elements/	science
/articles/dream-job-community-ranger/	science
/articles/govt-pearl-harbor/	war-and-peace
/articles/gl-history-great-migration/	war-and-peace
/articles/no-dapl-protest/	law
/articles/smi-sherlock-holmes-tools-deduction/	science
/articles/space-eyeballs/	science
/articles/beasts-death-valley/	science
/articles/india-cinemas-national-anthem/	law
/articles/lib-nasa-voyagers-to-the-stars/	science
/articles/wildfires-tennessee-warning/	science
/articles/trump-presidential-pets/	law
/articles/bio-philosophers-aristotle/	arts
/articles/gl-history-reconstruction/	war-and-peace
/articles/el-sistema-venezuela-crisis/	money
/articles/dream-job-science-writer/	science
/articles/young-garbage-collectors/	money
/articles/lib-nasa-nature-dark-matter/	science
/articles/japan-coca-cola/	money
/articles/lib-nasa-wind-blow/	science
/articles/bio-women-leaders-ruth-bader-ginsburg/	law
/articles/moana-princess-movie/	arts
/articles/studying-falling-cats/	science
/articles/dream-job-ukulele-teacher/	arts
/articles/scurvy-resurgence-australia/	health
/articles/govt-departments-federal-government/	law
/articles/lib-Nasa-volcano/	science
/articles/fake-news-fact-checker/	science
/articles/gl-history-american-civil-war/	war-and-peace
/articles/akron-kids-iss/	kids
/articles/dream-job-probation-officer/	law
/articles/electoral-college-divisive/	law
/articles/ants-farmers/	science
/articles/overview-oil-sands-keystone-pipeline-environment/	law
/articles/govt-cuban-missile-crisis/	war-and-peace
/articles/dream-job-volcanologist/	science
/articles/sharks-DNA/	science
/articles/trump-recount-voters/	law
/articles/bio-religious-leaders-martin-luther/	war-and-peace
/articles/corporal-punishment-king/	kids
/articles/no-coal-great-barrier-reef/	law
/articles/govt-cuba-bay-of-pigs-invasion/	war-and-peace
/articles/gl-history-remembering-alamo/	war-and-peace
/articles/medal-honor-2016/	war-and-peace
/articles/dachau-jacket/	war-and-peace
/articles/lib-procon-social-networking/	health
/articles/dream-job-solar-system-ambassador/	science
/articles/save-elephants-plan/	money
/articles/internet-world/	money
/articles/gl-history-essay-cold-war/	war-and-peace
/articles/lib-procon-video-game-violence/	opinion
/articles/pokemon-go-disaster/	health
/articles/fidel-castro-obit/	war-and-peace
/articles/bio-world-leaders-john-marshall/	law
/articles/dream-job-nasa-mission-project-manager/	science
/articles/hockey-vegas/	money
/articles/riley-dog-veterans/	health
/articles/lib-history-the-pilgrims/	arts
/articles/shopkins-toys/	kids
/articles/dream-job-app-developer/	science
/articles/lib-procon-school-uniforms/	kids
/articles/thanksgiving-storycorps-election/	kids
/articles/smi-avocado-dodo-extinct/	science
/articles/doomsday-hawking/	science
/articles/pandas-travel-china/	science
/articles/lib-history-mayflower-myths/	law
/articles/overview-obamacare/	law
/articles/lib-nasa-lightning-thunder/	science
/articles/gl-history-indian-removal-act/	war-and-peace
/articles/football-mexico/	sports
/articles/turkey-immigrant-thanksgiving/	science
/articles/wildfires-air-quality/	health
/articles/oldest-woman-space/	science
/articles/govt-president-cabinet/	law
/articles/pluto-icy-heart/	science
/articles/lib-history-native-american-cultures/	law
/articles/big-wave-contest/	sports
/articles/primary-sources-lincoln-thanksgiving/	law
/articles/octopus-restaurants/	money
/articles/lib-procon-vegetarianism/	health
/articles/cook-global-warming/	science
/articles/smi-first-thanksgiving-meal/	arts
/articles/pigs-optimism/	science
/articles/dream-job-soccer-player/	sports
/articles/facebook-google-fake-news/	law
/articles/lib-nasa-size-age-universe/	science
/articles/civil-war-voting/	law
/articles/gl-history-technology-1800s/	war-and-peace
/articles/headphone-earbuds/	health
/articles/historic-news-weird-thanksgiving/	arts
/articles/lib-nasa-history-of-rockets/	science
/articles/rubkis-cube-robot/	science
/articles/lib-procon-animal-testing/	science
/articles/schools-mindfulness-practice/	kids
/articles/dream-job-bee-keeper/	science
/articles/trump-school-lunch/	kids
/articles/space-brain/	science
/articles/dream-job-flight-systems-engineer/	science
/articles/bio-women-leaders-mother-teresa/	law
/articles/new-zealand-earthquake/	science
/articles/gl-history-abolition-of-slavery/	law
/articles/arctic-farming/	science
/articles/hamilton-caribbean/	money
/articles/lib-nasa-kuiper-belt/	science
/articles/india-rupee/	money
/articles/lib-procon-college-education/	money
/articles/lib-nasa-beyond-solar-system/	science
/articles/syria-wheelchair-journey/	war-and-peace
/articles/myths-orpheus-eurydice/	arts
/articles/norse-vikings/	arts
/articles/dream-job-plumber/	opinion
/articles/trump-schools/	kids
/articles/rats-tickling/	science
/articles/gl-history-underground-railroad/	war-and-peace
/articles/dream-job-planetary-protection-officer/	science
/articles/trump-obama-meet/	law
/articles/lib-nasa-planet-nine/	science
/articles/thanksgiving-day-shopping/	money
/articles/dream-job-subway-driver/	opinion
/articles/biggest-restaurant-mexico/	arts
/articles/american-muslim-reax/	war-and-peace
/articles/govt-history-veterans-day/	war-and-peace
/articles/speeches-trump-acceptance/	law
/articles/trump-climate-change/	law
/articles/wobble-chairs/	kids
/articles/speeches-hillary-clinton-concession/	law
/articles/lib-nasa-super-moon/	science
/articles/creepy-crawlies-census/	science
/articles/cow-tax-climatechange/	money
/articles/gl-history-burr-hamilton-duel/	war-and-peace
/articles/2016-election-congress-analysis/	law
/articles/myths-icarus/	arts
/articles/tonatiuh-childrens-books/	arts
/articles/lib-nasa-moon/	science
/articles/chimps-friends/	science
/articles/lib-nasa-pluto/	science
/articles/vote-from-space/	law
/articles/2016-trump-win/	law
/articles/ebola-virus-mutation/	health
/articles/lebanon-museum/	arts
/articles/antarctica-marine-reserve/	science
/articles/dream-job-guide-dog-trainer/	money
/articles/gl-history-founders-constitution-anti-federalists/	war-and-peace
/articles/lib-nasa-neptune-overview/	science
/articles/bio-activist-organizer-cesar-chavez/	law
/articles/bio-politicans-alexander-hamilton/	war-and-peace
/articles/students-vote-2016/	law
/articles/smi-election-1800/	law
/articles/gl-history-Ordinary-Americans-Constitution/	war-and-peace
/articles/probability-of-coincidences/	science
/articles/akron-anti-bullying/	kids
/articles/lib-nasa-uranus-overview/	science
/articles/indigenous-people-environment/	science
/articles/speeches-ronald-reagan-time-for-choosing/	law
/articles/lib-nasa-saturn-overview/	science
/articles/wimpy-kid-homecoming/	kids
/articles/myths-prometheus-pandora/	arts
/articles/nasa-laser-nose/	science
/articles/potato-gmo/	science
/articles/dream-job-landscape-gardeners/	opinion
/articles/legoland-dubai/	kids
/articles/lib-nasa-jupiter-overview/	science
/articles/world-series-cubs/	sports
/articles/dream-job-sports-presenter/	sports
/articles/standing-rock-facebook/	law
/articles/gl-history-indians-war-of-independence/	war-and-peace
/articles/military-horse/	war-and-peace
/articles/bio-world-leaders-vladimir-putin/	war-and-peace
/articles/slavery-inmate-protests/	law
/articles/smi-whigs-republicans/	law
/articles/lib-nasa-mars-overview/	science
/articles/day-of-dead/	arts
/articles/goldendoodle-supreme-court/	law
/articles/myths-echo-narcissus/	arts
/articles/dakota-pipeline-donation/	money
/articles/dream-job-interpreter/	law
/articles/sugary-drink-research/	health
/articles/lib-nasa-earth-overview/	science
/articles/gl-history-french-indian-war/	war-and-peace
/articles/myths-hades/	arts
/articles/dream-job-academic-researcher/	science
/articles/nfl-ratings/	sports
/articles/math-gender-gap-kids/	kids
/articles/crispr-snake-legs/	science
/articles/toxic-air-kids/	health
/articles/dream-job-author/	arts
/articles/lib-nasa-asteroids/	science
/articles/emoji-museum/	arts
/articles/myths-hercules/	arts
/articles/earthquake-prep-washington/	law
/articles/lib-nasa-venus-overview/	science
/articles/liberia-school-lunches/	kids
/articles/swift-flying-record/	science
/articles/dream-job-animal-adoption-agent/	money
/articles/gl-history-origins-pennsylvania-quakers/	war-and-peace
/articles/primary-source-life-at-mining-camp/	money
/articles/lib-nasa-mercury-overview/	science
/articles/dracula-castle/	money
/articles/syria-school-attack/	war-and-peace
/articles/outdoor-ed-oregon/	kids
/articles/japanese-whaling-culture/	law
/articles/lib-nasa-sun-overview/	science
/articles/dream-job-explorer/	opinion
/articles/gl-history-Indian-Slavery-in-the-Americas/	war-and-peace
/articles/dream-job-secret-service/	law
/articles/drone-hurricane-matthew/	science
/articles/karate-background/	sports
/articles/cigarettes-cancer-study/	health
/articles/new-zealand-hobbit/	money
/articles/lib-nasa-solar-system/	science
/articles/dream-job-paramedic/	health
/articles/lib-nasa-what-is-a-planet/	science
/articles/dream-job-investigative-reporter/	money
/articles/planet-nine/	science
/articles/american-sneaker-factories/	money
/articles/skateboard-kid-inventor/	kids
/articles/millipede-legs/	science
/articles/myths-cupid/	arts
/articles/dream-job-geneticist/	science
/articles/excessive-celebration/	sports
/articles/cubs-world-series-indians/	sports
/articles/gl-history-jamestown-english-america/	law
/articles/dream-job-restaurant-owner/	money
/articles/blue-leaves/	science
/articles/ice-experts-antarctica/	science
/articles/speeches-frederick-douglass-men-of-color-arms/	war-and-peace
/articles/myths-hera/	kids
/articles/dream-job-veterinary-nurse/	science
/articles/dream-job-graffiti-artist/	arts
/articles/europe-mars-landing/	science
/articles/pumpkin-zoo-animals/	kids
/articles/crossfit-pe-class/	kids
/articles/lexicon-vocabulary/	arts
/articles/lib-howto-pumpkin-carving/	kids
/articles/gl-history-perils-of-the-ocean/	war-and-peace
/articles/polar-bears-alaskan-natives/	science
/articles/smi-history-haunted-house/	money
/articles/syrian-students-enrollment/	kids
/articles/police-database-recognition/	law
/articles/dream-job-quantitative-analyst/	opinion
/articles/elk-cranberries/	science
/articles/lib-nasa-meteors-meteorites/	science
/articles/BHP-WH-you-say-revolution-95/	war-and-peace
/articles/dream-job-kung-fu-master/	arts
/articles/gl-history-north-america-eve-of-european-invasion/	war-and-peace
/articles/nba-guidelines-kids/	health
/articles/cinderella-elsa-veggies/	health
/articles/native-american-trail-app/	kids
/articles/obama-mars-companies/	money
/articles/third-presidential-debate/	law
/articles/lib-nasa-forces-baseball/	science
/articles/myths-perseus/	arts
/articles/dream-jobs-costume-shop-owner/	arts
/articles/dream-job-adoption-social-worker/	opinion
/articles/china-moon-mission/	science
/articles/georgetown-janitor-kindness/	money
/articles/robo-pilot/	science
/articles/bio-sports-duke-kahanamoku/	sports
/articles/myths-hermes/	kids
/articles/dream-job-animator/	opinion
/articles/dream-job-pathologist/	health
/articles/pokemon-go-health/	health
/articles/cat-feces-hawaii/	science
/articles/cereal-unpopular/	money
/articles/bird-fossil-squawk-box/	science
/articles/BHP-U7-4-greco-roman/	law
/articles/myths-aphrodite/	kids
/articles/lib-nasa-comets/	science
/articles/dream-job-heart-surgeon/	science
/articles/lebron-nba-union/	health
/articles/trip-advisor-animal-welfare/	money
/articles/jellyfish-new-zealand/	science
/articles/shakespeare-unauthorized/	arts
/articles/dream-job-primary-school-teacher/	opinion
/articles/smi-history-salem-witch-trials/	law
/articles/myths-rome-romulus-remus/	law
/articles/primary-source-john-white-roanoke/	war-and-peace
/articles/dylan-nobel-literature/	arts
/articles/school-based-farm/	kids
/articles/racist-roosevelt-statue/	law
/articles/beardog-fossil/	science
/articles/dream-job-inventor/	science
/articles/dream-job-architect/	money
/articles/dream-job-optician/	health
/articles/myths-poseidon/	kids
/articles/bio-civil-rights-harriet-beecher-stowe/	arts
/articles/mars-2030-obama/	science
/articles/hurricane-matthew-monitors/	science
/articles/pandas-endangered-status/	science
/articles/spanish-street-signs/	law
/articles/myths-zeus/	kids
/articles/overview-domesticating-drones/	science
/articles/bio-world-leader-king-tut/	war-and-peace
/articles/lost-cities-great-zimbabwe/	arts
/articles/pipeline-arrest-shailene-woodley/	law
/articles/toyota-talking-robot/	money
/articles/people-lifespans/	health
/articles/michelle-obama-garden/	law
/articles/dream-jobs-airplane-test-pilot/	money
/articles/lib-nasa-forces-airplane/	science
/articles/dream-jobs-forensic-scientist/	science
/articles/primary-source-harriet-jacobs-escape/	law
/articles/procon-anthem-protests/	opinion
/articles/holocaust-survivor-arts/	arts
/articles/girl-scouts-statues/	kids
/articles/body-image-election/	health
/articles/BHP-WH-crisis-conflict-96/	war-and-peace
/articles/primary-source-harriet-jacobs-childhood/	law
/articles/primary-source-assassination-caesar/	war-and-peace
/articles/lib-nasa-what-is-hurricane/	science
/articles/second-presidential-debate/	law
/articles/teva-elephant-national-zoo/	science
/articles/coral-twilight-zone/	science
/articles/3d-print-hand-violin/	arts
/articles/historic-news-halloween/	arts
/articles/lost-cities-pompeii/	science
/articles/primary-source-powhatan-john-smith/	war-and-peace
/articles/primary-source-hammurabi-code/	law
/articles/hurricane-matthew-florida/	money
/articles/overview-space-mining/	science
/articles/essay-ancient-greek-roman-worship/	arts
/articles/overview-skilled-immigrants/	law
/articles/lost-cities-babylon/	war-and-peace
/articles/pangolins-illegal-trade/	money
/articles/zedtown-zombies/	sports
/articles/rosie-tball-disability/	kids
/articles/implicit-bias-preschool/	kids
/articles/primary-source-banneker-letter-to-jefferson/	law
/articles/overview-antibiotic-resistance/	health
/articles/primary-source-eruption-vesuvius-pompeii/	science
/articles/overview-sunni-shiite-divide/	war-and-peace
/articles/hurricane-matthew-haiti/	money
/articles/science-candidates-respond/	science
/articles/vr-life-as-cows/	science
/articles/driverless-police-cars/	law
/articles/pence-kaine-vp-debate/	law
/articles/overview-jihad/	war-and-peace
/articles/overview-minimum-wages/	law
/articles/primary-source-crusades-saladin/	war-and-peace
/articles/overview-voting-rights/	law
/articles/african-american-olympians/	sports
/articles/produce-prescription/	health
/articles/insect-emotions/	science
/articles/bio-politicians-jill-stein/	law
/articles/bio-politicians-gary-johnson/	law
/articles/overview-wind-power/	science
/articles/overview-sanctions/	war-and-peace
/articles/rosetta-orbiter-end-journey/	science
/articles/autonomous-cars-access/	money
/articles/chess-center-kampala/	kids
/articles/your-name-japanese-movie/	arts
/articles/bio-politicians-tim-kaine/	law
/articles/primary-source-making-a-mummy/	arts
/articles/bio-politicians-mike-pence/	law
/articles/overview-guns-in-america/	war-and-peace
/articles/hot-peppers-burn/	science
/articles/kitten-bowl/	sports
/articles/mazy-trans-identity/	kids
/articles/soda-tax-sf/	health
/articles/overview-income-inequality/	money
/articles/overview-immigration-reform/	law
/articles/chimpanzee-sanctuary-birthday/	science
/articles/fun-jumpers/	sports
/articles/rhino-horn-trafficking-vietnam/	money
/articles/syrian-refugee-family-fresno/	war-and-peace
/articles/smi-chocolate-history/	money
/articles/overview-fracking/	law
/articles/jose-fernandez-obit/	sports
/articles/polyface-disney-costume/	kids
/articles/smi-langston-hughes/	arts
/articles/new-take-prime-numbers/	science
/articles/overview-el-nino-la-nina/	science
/articles/BHP-U8-3-ibn-battuta/	science
/articles/nba-protest-talks/	sports
/articles/clinton-millennial-voters/	law
/articles/iran-drag-racing/	sports
/articles/indian-happiness-institute/	science
/articles/first-presidential-debate/	law
/articles/bio-politicians-hillary-clinton/	law
/articles/overview-how-the-us-elects-presidents/	law
/articles/bio-politicians-donald-trump/	law
/articles/football-sherman-protests/	sports
/articles/football-stadiums-texas/	sports
/articles/cuba-pampered-dogs/	money
/articles/overview-arctic-opportunity/	money
/articles/bio-musician-jimi-hendrix/	arts
/articles/zuckerberg-disease-eradication/	health
/articles/mount-rushmore-tourism/	money
/articles/murals-walls-peace-day/	war-and-peace
/articles/hiroshima-okonomiyaki/	war-and-peace
/articles/overview-batteries/	science
/articles/lost-cities-cahokia/	arts
/articles/charlotte-protests/	law
/articles/kea-extinction/	science
/articles/soccer-injuries-soaring/	sports
/articles/sweden-tax-repairs/	law
/articles/smi-genocide-Colonial-Africa/	war-and-peace
/articles/overview-middle-class/	law
/articles/underwater-volcano-hawaii-exploration/	science
/articles/self-driving-cars-laws-fed/	law
/articles/mammoth-skull-discovery/	science
/articles/teen-runner-michelle-cross/	kids
/articles/primary-source-amendment-constitution/	law
/articles/overview-gdp/	money
/articles/cuttlefish-math/	science
/articles/cup-noodles-healthy/	health
/articles/us-mexico-schools/	kids
/articles/microplastics-expedition/	science
/articles/overview-gene-editing/	science
/articles/overview-racial-profiling/	law
/articles/african-american-museum/	opinion
/articles/pizza-making-robots/	science
/articles/crows-tools/	science
/articles/amelia-earhart-investigator/	science
/articles/bio-explorer-leif-eriksson/	war-and-peace
/articles/overview-confronting-coal/	science
/articles/black-women-nasa-history/	science
/articles/hijab-emoji/	kids
/articles/first-flag-debate/	opinion
/articles/trees-fight-back/	science
/articles/smi-sarah-winnemucca-native-americans-us/	war-and-peace
/articles/overview-us-supreme-court/	law
/articles/animal-free-dairy/	health
/articles/hms-terror-discovery/	science
/articles/amazon-tribe-forest/	health
/articles/teen-soap-charity/	kids
/articles/overview-solar-energy/	science
/articles/bio-musicians-celia-cruz/	arts
/articles/nasa-twins-study/	science
/articles/nativeamerican-students/	kids
/articles/michigan-youth-concussions/	sports
/articles/zoo-paintings-animal-artists/	arts
/articles/overview-us-war-powers/	war-and-peace
/articles/overview-drug-prices/	health
/articles/procon-self-driving-cars-future/	opinion
/articles/discrimination-muslim-students/	kids
/articles/comics-nitehawk/	arts
/articles/ancient-cone-fossils/	science
/articles/smi-berlin-train-station-housing-refugees/	war-and-peace
/articles/storr-lochs-monster/	science
/articles/grizzly-bear-ca-reintroduction/	science
/articles/maya-calendar-oldest-manuscript/	science
/articles/bio-inventor-wright-brothers/	science
/articles/female-pilot-arlington/	war-and-peace
/articles/bio-musician-wolfgang-mozart/	arts
/articles/overview-the-flu/	science
/articles/overview-what-to-eat/	health
/articles/overview-perils-of-polling/	law
/articles/sept-11-flag/	arts
/articles/endangered-great-apes/	science
/articles/swimmer-blind-paraolympics/	sports
/articles/asteroid-chase-five-years/	science
/articles/bio-musician-ludwig-van-beethoven/	arts
/articles/overview-sharing-economy/	money
/articles/dog-brain-scan/	science
/articles/fda-anti-bacterial-soap/	health
/articles/japan-mascots/	arts
/articles/global-warming-experiment/	science
/articles/bio-musician-bob-dylan/	arts
/articles/overview-the-internet-of-things/	science
/articles/asiatic-cheetahs-iran/	science
/articles/jupiter-new-images/	science
/articles/kenyan-village-king-beasts/	money
/articles/anti-zika-bee-death/	health
/articles/smi-books-critical-part-win-world-war-II/	war-and-peace
/articles/overview-the-spectrum/	science
/articles/football-player-lunch-buddy/	kids
/articles/dwayne-wade-chicago-violence/	war-and-peace
/articles/georgetown-slavery-admission/	law
/articles/tech-gear-sports/	sports
/articles/overview-gmos-engineered-food/	science
/articles/overview-bee-blight/	science
/articles/flying-reptile-prehistoric/	science
/articles/north-dakota-pipeline/	law
/articles/star-spangled-banner-games/	sports
/articles/forgotten-civil-rights-sites/	law
/articles/nasa-mars-hawaii-experiment/	science
/articles/bio-philosophers-jean-paul-sartre/	law
/articles/smi-reading-writing-pompeii-wall/	war-and-peace
/articles/bio-royalty-anastasia-romonov/	war-and-peace
/articles/proxima-b-question-answer/	science
/articles/lucky-fins/	kids
/articles/st-louis-fountains-schools/	opinion
/articles/lucy-fossil-mystery/	science
/articles/smi-magna-carta-viral/	war-and-peace
/articles/bio-musician-john-lennon/	arts
/articles/speeches-mlk-dream/	law
/articles/smi-what-is-Cuneiform/	science
/articles/primary-source-mlk-birmingham-jail/	law
/articles/kaepernick-anthem-protest/	sports
/articles/tour-ocean-worlds/	science
/articles/nigerian-comic-book/	arts
/articles/virtual-reality-obama-national-parks/	science
/articles/smi-tunnel-escape-berlin-wall/	war-and-peace
/articles/smi-british-warships-world-war-i/	war-and-peace
/articles/bio-inventors-goodall/	science
/articles/smi-icemen-stomach-bugs-ancient-human-migration/	science
/articles/national-parks-100-years/	law
/articles/family-baking-business/	kids
/articles/moana-disney-diversity/	opinion
/articles/tribe-fossil-fuels-protest/	money
/articles/smi-farming-incas/	science
/articles/bio-philosopher-henry-david-thoreau/	law
/articles/smi-honey-eternal-shelf-life/	science
/articles/bio-musician-aretha-franklin/	arts
/articles/earth-next-door/	science
/articles/obama-monument-hawaii/	science
/articles/trump-deportations-check/	law
/articles/frankenstein-anniversary/	arts
/articles/bio-philosophers-confucius/	law
/articles/smi-war-of-1812/	war-and-peace
/articles/smi-American-battle-of-waterloo/	war-and-peace
/articles/italy-earthquake/	war-and-peace
/articles/seattle-multiracial-diversity/	kids
/articles/beach-burkini-ban/	law
/articles/sunken-war-ship-independence/	war-and-peace
/articles/bio-philosophers-rene-descartes/	law
/articles/smi-origins-wwi-agreement-middle-east/	war-and-peace
/articles/smi-plague-infecting-humans-3300-years-earlier/	science
/articles/bio-musician-josephine-baker/	arts
/articles/smi-mobydick-essex/	arts
/articles/bio-musician-ravi-shankar/	arts
/articles/smi-cleopatra-mythology/	war-and-peace
/articles/smi-american-revolution-liberty-tree/	war-and-peace
/articles/smi-medieval-mongol-rise/	war-and-peace
/articles/smi-species-insights-dolphins-humans/	science
/articles/chimps-reward-cooperation/	science
/articles/july-hottest-month/	science
/articles/latinos-longevity/	health
/articles/virginia-voting-rights/	law
/articles/bio-musician-nina-simone/	arts
/articles/bio-musician-bob-marley/	arts
/articles/bio-musician-janelle-monae/	arts
/articles/bio-entrepreneurs-anna-bissell/	money
/articles/happier-meal-mcdonalds/	health
/articles/baby-panda-diplomat/	war-and-peace
/articles/teachers-displaced-flooding-la/	kids
/articles/maker-movement-science-tinkerers/	science
/articles/bio-author-cs-lewis/	arts
/articles/BHP-WH-8-3-One-lump-or-two/	war-and-peace
/articles/bio-inventor-Louis-Braille/	science
/articles/bio-entrepreneurs-milton-hershey/	money
/articles/physicist-fifth-force/	science
/articles/athletes-burnout/	sports
/articles/worlds-largest-aircraft/	science
/articles/poverty-from-space/	money
/articles/bio-civil-rights-mlk-jr/	law
/articles/bio-author-robert-louis-stevenson/	arts
/articles/bio-musician-carlos-santana/	arts
/articles/bio-entrepreneurs-jay-z/	arts
/articles/koalas-tree-clearing/	money
/articles/police-shootings-black-recruit/	law
/articles/air-pollution-true-cost/	opinion
/articles/zenkerella-mammal/	science
/articles/BHP-WH-why-tshirts-so-cheap-94/	war-and-peace
/articles/bio-civil-rights-john-brown/	law
/articles/bio-civil-rights-medgar-evers/	war-and-peace
/articles/bio-entrepreneurs-madam-cj-walker/	money
/articles/bio-author-richard-wright/	arts
/articles/elephants-last-megaherbivores/	science
/articles/navajo-mine-waste-spill/	money
/articles/innovation-discontents/	opinion
/articles/music-scholarships-hope/	arts
/articles/bio-world-leader-henry-viii/	war-and-peace
/articles/primary-source-jackson-cherokee-letter/	war-and-peace
/articles/bio-world-leader-joseph-stalin/	war-and-peace
/articles/bio-entrepreneurs-steve-jobs/	money
/articles/louisiana-flood-climate-change/	science
/articles/mayan-languages-immigration/	law
/articles/madagascar-seeds/	science
/articles/olympics-hosts-procon/	opinion
/articles/bio-inventor-alexander-graham-bell/	science
/articles/bio-inventor-louis-pasteur/	science
/articles/bio-author-roald-dahl/	arts
/articles/bio-philosophers-socrates/	arts
/articles/animal-rehabilitator/	science
/articles/human-right-speak-languages/	opinion
/articles/dinosaur-surviving-mammal/	science
/articles/simone-biles-coach-partnership/	sports
/articles/smi-lunch-counter-segregation/	law
/articles/bio-world-leader-Hatshepsut/	war-and-peace
/articles/bio-author-madeleine-l-engle/	arts
/articles/bio-civil-rights-ruby-bridges/	war-and-peace
/articles/bio-world-leader-caesar/	war-and-peace
/articles/silva-olympian-judo-favela/	sports
/articles/greenland-shark-oldest-vertebrate/	science
/articles/refugees-small-towns/	war-and-peace
/articles/olympics-practice/	sports
/articles/bio-inventor-ben-franklin/	science
/articles/bio-military-leaders-pancho-villa/	war-and-peace
/articles/bio-war-peace-robert-e-lee/	war-and-peace
/articles/bio-entrepreneurs-oprah-winfrey/	arts
/articles/simone-manuel-olympics-swimming/	sports
/articles/island-fox-comeback/	science
/articles/opinion-understanding-adoption/	opinion
/articles/china-flood/	science
/articles/bio-entrepreneurs-levi-strauss/	money
/articles/bio-explorer-vasco-da-gama/	war-and-peace
/articles/bio-author-george-orwell/	arts
/articles/bio-civil-rights-desmond-tutu/	war-and-peace
/articles/bio-civil-rights-dolores-huerta/	arts
/articles/running-circles-east-african-runners/	sports
/articles/skydiving-siblings/	sports
/articles/students-teachers-mindfulness/	kids
/articles/donating-old-furs/	science
/articles/bio-sports-wilma-rudolph/	sports
/articles/bio-sports-serena-williams/	sports
/articles/primary-source-indies-devastation/	war-and-peace
/articles/bio-sports-bethany-hamilton/	sports
/articles/iran-pokemon-go/	kids
/articles/brazil-natural-hair/	health
/articles/degas-art-mystery/	arts
/articles/blade-runners-advantage/	sports
/articles/bio-author-ray-bradbury/	arts
/articles/bio-author-phillis-wheatley/	arts
/articles/bio-author-edgar-allan-poe/	arts
/articles/speeches-chavez-commonwealthclub/	law
/articles/bio-author-mark-twain/	arts
/articles/end-of-world-records/	sports
/articles/digital-books-galore/	kids
/articles/understanding-electoral-college/	opinion
/articles/fruit-science-summer-camp/	science
/articles/bio-author-sarah-winnemucca/	law
/articles/bio-military-leaders-emiliano-zapata/	war-and-peace
/articles/hover-bike-smart-watch/	kids
/articles/sloths-laid-back/	science
/articles/displaced-rio-olympics/	money
/articles/amish-farming-asthma/	science
/articles/bio-women-leaders-sandra-day-o-connor/	law
/articles/bio-women-leaders-florence-nightingale/	health
/articles/bio-author-homer/	arts
/articles/bio-women-leaders-helen-keller/	health
/articles/fairy-penguin-zoo/	kids
/articles/food-italy-doggy-bag/	law
/articles/captain-cook-statues-defaced/	law
/articles/new-treatment-food-allergies/	science
/articles/primary-source-carter-king-tut/	money
/articles/bio-religious-leader-buddha/	war-and-peace
/articles/bio-author-maya-angelou/	arts
/articles/bio-artist-michelangelo/	arts
/articles/robot-patients-hospital/	health
/articles/junior-olympics-surprise-sheppard/	kids
/articles/how-to-fix-american-policing/	law
/articles/birds-bees-cool-off/	science
/articles/BHP-7-1-aksum/	war-and-peace
/articles/BHP-U5-6-biology-awareness/	science
/articles/historic-news-child-labor-coal-mines/	law
/articles/primary-source-middle-passage/	war-and-peace
/articles/bio-world-leader-napolean/	war-and-peace
/articles/bio-women-leaders-malala-yousafzai/	war-and-peace
/articles/homeland-security-chief-story/	war-and-peace
/articles/natural-disasters-rome-volcano/	science
/articles/roller-coaster-height/	kids
/articles/country-heights-study/	health
/articles/bio-civil-rights-sojourner-truth/	law
/articles/historic-news-lincoln-douglas-debates/	law
/articles/historic-news-alexander-graham-bell-telephone/	science
/articles/primary-source-wwilson-leagueofnations/	war-and-peace
/articles/bio-civil-rights-booker-t-washington/	law
/articles/bio-world-leader-fidel-castro/	war-and-peace
/articles/baltimore-skating-refuge/	sports
/articles/simone-biles-incredible-balance/	science
/articles/girls-summer-coding-camps/	kids
/articles/millions-cows-one-app/	money
/articles/bio-civil-rights-ida-b-wells/	law
/articles/BHP-U2-8-structure-scientific-revolutions/	science
/articles/historic-news-oklahoma-land-rush/	law
/articles/epitaph-for-cursive/	kids
/articles/olympics-boxing-balderas/	sports
/articles/anthropology-mummy-hair-low-stress-life/	science
/articles/bio-leader-genghis-khan/	war-and-peace
/articles/protect-wolves-or-not/	law
/articles/bio-world-leader-nelson-mandela/	war-and-peace
/articles/foster-kid-horse-race/	sports
/articles/ice-bucket-challenge-research/	health
/articles/cockroach-milk/	health
/articles/bio-activist-harvey-milk/	law
/articles/bio-inventor-nikola-tesla/	science
/articles/bio-world-leader-alexander-thegreat/	war-and-peace
/articles/bio-world-leader-mary-queen-of-scots/	war-and-peace
/articles/solar-plane-round-the-world/	science
/articles/wild-birds-honey/	science
/articles/cow-dung-electricity/	science
/articles/bio-entrepreneur-bill-gates/	science
/articles/bio-explorer-squanto/	war-and-peace
/articles/turtle-racing-minneapolis/	kids
/articles/opinion-how-transform-education-system/	opinion
/articles/bio-women-leaders-sonia-sotomayor/	law
/articles/bio-religious-leader-dalai-lama/	war-and-peace
/articles/BHP-U5-1-lifepurpose/	science
/articles/BHP-U6-5-chardin/	science
/articles/BHP-U4-3-WEGENER-HESS/	science
/articles/BHP-U9-1-acceleration/	science
/articles/BHP-WH-83-She-blinded-me-with-science/	science
/articles/BHP-U7-2-agrarian-civilizations-intro/	science
/articles/BHP-WH-The-Columbian-Exchange/	war-and-peace
/articles/BHP-U9-3-anthropocene/	science
/articles/BHP-U9-5-smith-marx-keynes/	science
/articles/BHP-WH-71112-Origin-of-world-religions/	war-and-peace
/articles/BHP-U3-2-AlchemyChemistry/	science
/articles/BHP-U3-1-HistorySilver/	science
/articles/BHP-U6-2-foraging/	science
/articles/BHP-U5-5-watson-crick/	science
/articles/BHP-U8-1-world-zones/	science
/articles/BHP-U2-5-EdwinHubble/	science
/articles/BHP-U2-4-IsaacNewton/	science
/articles/BHP-U2-2-GalileoGalilei/	science
/articles/historic-news-battle-new-orleans-war-1812/	war-and-peace
/articles/historic-news-slave-auction-new-orleans/	law
/articles/bio-women-leaders-joan-of-arc/	war-and-peace
/articles/bio-world-leader-charlemagne/	war-and-peace
/articles/bio-sports-jackie-robinson/	sports
/articles/bio-world-leader-queen-victoria/	war-and-peace
/articles/trees-stop-crime/	law
/articles/chemists-pollution-energy/	science
/articles/primary-source-indian-removal/	war-and-peace
/articles/bio-world-leader-mohandas-gandhi/	war-and-peace
/articles/bio-world-leader-mao-zedong/	war-and-peace
/articles/bio-world-leader-queen-elizabeth-I/	war-and-peace
/articles/australian-balloon-voyage/	sports
/articles/tinkering-with-a-mission/	kids
/articles/maya-society-bones/	science
/articles/bio-military-leaders-king-kamehameha-I/	war-and-peace
/articles/bio-world-leader-che-guevara/	war-and-peace
/articles/bio-military-leaders-douglas-macarthur/	war-and-peace
/articles/ban-other-box/	kids
/articles/bio-author-anne-frank/	war-and-peace
/articles/bio-scientists-stephen-hawking/	science
/articles/bio-world-leader-winston-churchill/	war-and-peace
/articles/bio-women-leaders-nefertiti/	war-and-peace
/articles/bio-sports-mia-hamm/	sports
/articles/refugees-school-syria-lebanon/	kids
/articles/lgbt-history-classrooms/	kids
/articles/bio-women-leaders-sacagawea/	war-and-peace
/articles/bio-explorer-pocahontas/	war-and-peace
/articles/bio-civil-rights-rosa-parks/	law
/articles/bio-women-leaders-susan-b-anthony/	law
/articles/bio-civil-rights-harriet-tubman/	law
/articles/jiu-jitsu-sisters/	sports
/articles/refugee-school-soccer-field/	sports
/articles/historic-news-lusitania-WWI/	war-and-peace
/articles/historic-news-oregon-trail/	war-and-peace
/articles/bio-explorer-mae-jemison/	science
/articles/bio-inventor-da-vinci/	science
/articles/bio-world-leader-adolf-hitler/	war-and-peace
/articles/melania-trump-f/	kids
/articles/freeways-civil-rights/	law
/articles/bio-explorer-Meriwether-Lewis/	science
/articles/bio-explorer-ferdinand-magellan/	science
/articles/baton-rouge-police-shooting-danger/	law
/articles/bio-civil-rights-nat-turner/	law
/articles/bio-civil-rights-stokely-carmichael/	law
/articles/pokemon-augmented-reality/	science
/articles/primary-source-plessy-ferguson/	law
/articles/bio-civil-rights-frederick-douglass/	law
/articles/bio-civil-rights-malcolm-x/	law
/articles/turkey-coup-attempt/	war-and-peace
/articles/food-waste-new-research/	money
/articles/bio-civil-rights-thurgood-marshall/	law
/articles/bio-artist-vincent-van-gogh/	arts
/articles/bio-author-nellie-bly/	arts
/articles/theresa-may-prime-minister/	war-and-peace
/articles/13yo-college-acceptance/	kids
/articles/historic-news-lynching/	law
/articles/historic-news-custers-last-stand/	war-and-peace
/articles/bio-author-shakespeare/	arts
/articles/bio-sports-jesse-owens/	sports
/articles/bio-sports-jim-thorpe/	sports
/articles/nice-france-truck-attack/	war-and-peace
/articles/girlscouts-saving-energy/	kids
/articles/womens-olympic-gymnastics/	sports
/articles/speeches-sojourner-truth-woman/	war-and-peace
/articles/bio-entrepreneur-walt-disney/	money
/articles/bio-entrepreneur-john-d-rockefeller/	money
/articles/tesla-selfdriving-carcrash/	science
/articles/bio-world-leader-cleopatra/	law
/articles/bio-entrepreneur-andrew-carnegie/	money
/articles/bio-inventor-johannes-gutenberg/	science
/articles/bio-inventor-albert-einstein/	science
/articles/pokemon-go-injuries/	kids
/articles/fish-legs-robot/	science
/articles/dolphin-feeding-dangers/	science
/articles/bio-explorer-sir-francis-drake/	war-and-peace
/articles/bio-inventor-neil-degrasse-tyson/	science
/articles/opinion-climate-change-education/	opinion
/articles/bio-inventor-eli-whitney/	science
/articles/bio-explorer-james-cook/	money
/articles/dolly-sheep-cloning-years-later/	science
/articles/concussions-brain-changes/	health
/articles/bio-explorer-amelia-earhart/	science
/articles/bio-inventor-george-washington-carver/	science
/articles/bio-inventor-thomas-edison/	science
/articles/bio-explorer-edmund-hillary/	sports
/articles/bio-explorer-william-clark/	war-and-peace
/articles/bio-inventor-ada-lovelace/	science
/articles/bio-entrepreneur-henry-ford/	money
/articles/shootings-dallas-minnesota-louisiana/	war-and-peace
/articles/china-radio-dish/	science
/articles/olympic-athletes-money/	sports
/articles/journey-to-jupiter/	science
/articles/robot-escape-russia/	science
/articles/panama-canal-opening/	science
/articles/elie-wiesel-obituary/	war-and-peace
/articles/gabby-douglas-olympics/	sports
/articles/marine-desert-tortoises/	war-and-peace
/articles/tech-jobs-africa/	opinion
/articles/maui-disney-polynesian-stereotype/	kids
/articles/elaborate-treehouse-builder/	kids
/articles/antarctica-tourism/	money
/articles/finding-dory-animator/	arts
/articles/bio-explorer-neil-armstrong/	science
/articles/primary-source-marshallplan/	war-and-peace
/articles/speeches-fdr-fourfreedoms/	law
/articles/speeches-elizabethcadystanton-suffrage/	law
/articles/speeches-chavez-church/	law
/articles/primary-source-test-ban-treaty/	war-and-peace
/articles/primary-source-jefferson-slavery/	war-and-peace
/articles/primary-source-articles-confederation/	law
/articles/messi-retiring-football/	sports
/articles/veterans-sports-invictus/	sports
/articles/primary-source-declaration-independence/	law
/articles/primary-source-rights-of-man/	law
/articles/bio-explorer-daniel-boone/	war-and-peace
/articles/bio-explorer-christopher-columbus/	war-and-peace
/articles/BHP-U8-6-first-silk-roads/	science
/articles/BHP-U2-7-TychoBrahe/	science
/articles/BHP-U7-africa-agriculture/	science
/articles/BHP-U5-4-darwin-evolution-faith/	science
/articles/john-lewis-civil-disobedience/	law
/articles/immigration-protection-scotus/	law
/articles/brexit-vote-leave/	law
/articles/glowing-cement/	science
/articles/cambodia-hidden-city/	science
/articles/auschwitz-guard-trial/	war-and-peace
/articles/phone-sniffing-dog/	law
/articles/shark-saving-cuba-us/	science
/articles/lebron-cleveland-victory/	sports
/articles/uk-gender-neutral-uniform/	kids
/articles/avoid-bee-attacks/	health
/articles/earthquake-test-six-story-building/	science
/articles/primary-source-hawaii-annexation/	war-and-peace
/articles/primary-source-columbus-letter/	money
/articles/primary-source-troosevelt-corollary/	war-and-peace
/articles/primary-source-treaty-hidalgo/	war-and-peace
/articles/primary-source-marbury-madison/	law
/articles/primary-source-seneca-falls/	law
/articles/primary-source-federalist-51/	law
/articles/primary-source-japanese-exclusion/	war-and-peace
/articles/primary-source-fugitive-slave-act/	law
/articles/primary-source-emancipation/	war-and-peace
/articles/primary-source-constitution/	law
/articles/primary-source-civil-rights-act/	law
/articles/primary-source-billofrights/	law
/articles/venezuela-schools-failing/	kids
/articles/why-people-eat-disgusting-things/	science
/articles/shanghai-disneyland-opening/	money
/articles/dolphin-sanctuary/	science
/articles/primary-source-monroe-doctrine/	war-and-peace
/articles/primary-source-jefferson-expansion/	war-and-peace
/articles/BHP-WH-When-Humans-Became-Inhumane/	war-and-peace
/articles/BHP-WH-972-Gandhi/	law
/articles/BHP-WH-7-Were-not-in-kansas/	war-and-peace
/articles/BHP-WH-708-Whats-for-dinner/	war-and-peace
/articles/BHP-U9-2-industrial-revolution/	science
/articles/BHP-U8-5-zheng-he/	science
/articles/BHP-U8-4-marco-polo/	science
/articles/BHP-U8-11-Horses/	science
/articles/BHP-U7-9-timekeeping/	science
/articles/BHP-U7-8-recordkeeping/	science
/articles/BHP-U7-7-uruk/	science
/articles/BHP-U7-6-mesoamerica/	science
/articles/BHP-U7-5-jericho/	science
/articles/BHP-7-1-Ghana/	war-and-peace
/articles/primary-source-brown-vs-board/	law
/articles/primary-source-federalist-10/	law
/articles/primary-source-ferdinand-letter/	war-and-peace
/articles/russian-doping-ban-track-field/	sports
/articles/newts-snakes/	science
/articles/malnutrtition-third-of-world/	health
/articles/slime-mold/	science
/articles/historic-news-arizona-newmexico-statehood/	law
/articles/elephant-seals-global-warming/	science
/articles/senate-fillibuster-guns/	law
/articles/animal-trophies-exported/	money
/articles/inclusive-classrooms-opinion/	opinion
/articles/dog-meat-protests/	law
/articles/worst-massacres-history/	war-and-peace
/articles/harry-potter-science/	kids
/articles/braille-reading-finalist/	kids
/articles/cities-history-alexandria/	law
/articles/chronic-absenteeism-report/	kids
/articles/hand-transplant/	science
/articles/poor-boy-rich-neighbors/	kids
/articles/new-monument-petra/	arts
/articles/historic-news-tesla-niagara/	science
/articles/historic-news-ellis-island/	law
/articles/historic-news-frederick-douglass-obit/	law
/articles/BHP-U5-7-darwin-bio/	science
/articles/BHP-U5-3-extinction-event/	science
/articles/BHP-U5-2-biosphere/	science
/articles/BHP-U4-6-codex/	science
/articles/BHP-U4-5-geologyprinciples/	science
/articles/BHP-U4-4-eratosthenes/	science
/articles/BHP-U4-1-solarsystem/	science
/articles/BHP-U3-4-MarieCurie/	science
/articles/BHP-U3-3-DmitriMendeleev/	science
/articles/BHP-U2-1-ClaudiusPtolemy/	science
/articles/BHP-6-SJGates-biography/	science
/articles/BHP-5-Banneker/	science
/articles/BHP-U2-6-HenriettaLeavitt/	science
/articles/BHP-U2-3-NicolausCopernicus/	science
/articles/BHP-U2-0-approaches-knowledge/	science
/articles/BHP-U1-8-Greek/	science
/articles/curry-james-olympics/	sports
/articles/texas-valedictorian-undocumented/	law
/articles/911-dog-death/	war-and-peace
/articles/greek-ruins-bacteria/	science
/articles/BHP-U8-9-Columbian-Exchange/	science
/articles/BHP-U1-zulu-origin-story/	science
/articles/BHP-U1-efik-origin-story/	science
/articles/BHP-U1-7-Mayan/	science
/articles/BHP-U1-6-Iroquois/	science
/articles/BHP-U1-5-Judeochristian/	science
/articles/BHP-10-africa-slavery/	war-and-peace
/articles/venezuela-trash-digging/	money
/articles/malia-obama-graduation/	kids
/articles/youth-prisons-five-reasons/	law
/articles/crocodiles-everglades/	science
/articles/BHP-U1-4-chinese/	science
/articles/BHP-U6-3-lucy-leakey/	science
/articles/BHP-WH-imperialism-modern-95/	war-and-peace
/articles/orlando-shooting-politics/	law
/articles/third-grade-trump-supporter/	kids
/articles/collie-glacier-national-park/	science
/articles/expanding-universe-math/	science
/articles/speeches-winthrop-cityonahill/	law
/articles/speeches-gbush-iraq/	war-and-peace
/articles/speeches-lincoln-second-inaugral/	war-and-peace
/articles/venezuela-urban-farming/	money
/articles/ferguson-coloring-book/	kids
/articles/giant-sponge-hawaii/	science
/articles/wolf-dens/	science
/articles/clinton-nominee-woman/	law
/articles/zika-rio-opinion/	opinion
/articles/jurassic-park-paleontologist/	science
/articles/grizzlies-polarbears/	science
/articles/king-tut-extraterrestrial-dagger/	science
/articles/space-wars/	science
/articles/pakistani-pigeons/	sports
/articles/rainier-american-idol/	money
/articles/cities-history-johannesburg/	law
/articles/bio-firstlady-mobama/	law
/articles/bio-firstlady-lbush/	law
/articles/bio-firstlady-hclinton/	law
/articles/bio-firstlady-bbush/	war-and-peace
/articles/bio-firstlady-nreagan/	law
/articles/bio-firstlady-rcarter/	law
/articles/bio-firstlady-eford/	law
/articles/bio-firstlady-pnixon/	war-and-peace
/articles/bio-firstlady-ladyjohnson/	war-and-peace
/articles/bio-firstlady-jkennedy/	arts
/articles/bio-firstlady-ewilson/	law
/articles/bio-firstlady-eroosevelt/	war-and-peace
/articles/bio-firstlady-charrison/	law
/articles/bio-firstlady-mlincoln/	law
/articles/bio-firstlady-hlane/	law
/articles/bio-firstlady-afillmore/	law
/articles/bio-firstlady-spolk/	law
/articles/bio-firstlady-dmadison/	law
/articles/bio-firstlady-aadams/	law
/articles/chess-ferguson/	kids
/articles/opinion-gold-childlabor/	opinion
/articles/kushti-wrestling/	sports
/articles/comets-life/	science
/articles/cities-history-amsterdam/	law
/articles/obit-muhammad-ali/	sports
/articles/china-scariest-run/	kids
/articles/vocal-delivery/	law
/articles/earth-laughinggas/	science
/articles/washington-slaves/	law
/articles/schoolslocal-procon/	opinion
/articles/neanderthals-structure/	science
/articles/wolf-reputation/	science
/articles/hiroshima-101/	war-and-peace
/articles/gorilla-child/	law
/articles/textbook-mexico/	kids
/articles/veggie-juicyburger/	health
/articles/cloud-seeding/	science
/articles/turtle-temperature/	science
/articles/blackdeath-pottery/	science
/articles/lobster-trade/	money
/articles/opinion-obamahiroshima/	opinion
/articles/deaf-speller/	kids
/articles/pools-cdc/	health
/articles/mars-tsunami/	science
/articles/wildlife-camera/	science
/articles/everest-oxygen/	sports
/articles/sea-monster/	science
/articles/opinion-tobacco-childlabor/	opinion
/articles/nasa-robots/	science
/articles/giraffe-genetics/	science
/articles/foodlabels-makeover/	health
/articles/trout-school/	kids
/articles/fruits-genetics/	science
/articles/vr-sports/	sports
/articles/endangered-vaquita/	science
/articles/pullup-record/	sports
/articles/schools-resegregation/	kids
/articles/artificial-wave/	sports
/articles/columbus-letter/	money
/articles/cicada-returns/	science
/articles/historic-news-12years-slave/	law
/articles/turtle-armor/	science
/articles/mexico-siliconvalley/	money
/articles/space-dust/	science
/articles/kids-breakfast/	opinion
/articles/historic-news-puerto-rico-invasion/	war-and-peace
/articles/historic-news-horselesscarriage/	science
/articles/cities-history-soulcity/	money
/articles/cities-history-newdelhi/	law
/articles/cities-history-kingston/	law
/articles/cities-history-paris/	law
/articles/cities-history-losangeles/	law
/articles/cities-history-newyork/	law
/articles/cities-history-berlin/	war-and-peace
/articles/cities-history-barcelona/	law
/articles/cities-history-hiroshima/	law
/articles/cities-history-panama/	law
/articles/cities-history-beijing/	law
/articles/cities-history-philadelphia/	law
/articles/cities-history-london/	law
/articles/big-bang/	science
/articles/recess-law/	kids
/articles/plants-extinct/	science
/articles/cheating-tech/	law
/articles/speeches-john-brown-court/	law
/articles/cities-history-benin/	law
/articles/cities-history-baghdad/	law
/articles/cities-history-rome/	law
/articles/cities-history-potosi/	law
/articles/speeches-eugenedebs-courtstatement/	law
/articles/speeches-redjacket-religion/	law
/articles/deepsleep-memory/	science
/articles/india-diamond/	opinion
/articles/early-americans/	science
/articles/kenya-ivoryburn/	opinion
/articles/dinosaur-geology/	science
/articles/jury-race/	law
/articles/beach-mentalhealth/	health
/articles/braincontrolled-drone/	science
/articles/albertawildfire-climatechange/	science
/articles/undrafted-underclassmen/	sports
/articles/obama-transgenderbathrooms/	law
/articles/obama-howardcommencement/	law
/articles/historic-news-first-congresswoman/	law
/articles/sthelens-earthquake/	science
/articles/women-welding/	money
/articles/yearbook-dying/	money
/articles/keplertelescope-newplanets/	science
/articles/historic-news-sanfranciscoearthquake/	science
/articles/speeches-bwashington-atlantacompromise/	law
/articles/speeches-gford-officeremarks/	law
/articles/speeches-htruman-hiroshima/	war-and-peace
/articles/greece-parthenonmarbles/	arts
/articles/curry-mvp/	sports
/articles/breakthrough-starshot/	science
/articles/salamanders-female/	science
/articles/historic-news-bostonmassacre/	war-and-peace
/articles/alberta-wildfire/	science
/articles/ncjusticedept-bathroom/	law
/articles/petcube-skype/	money
/articles/smart-cities/	law
/articles/germanjews-muslimmigrants/	war-and-peace
/articles/orangutan-jungleschool/	science
/articles/dc-statehood/	law
/articles/unmanned-ships/	science
/articles/historic-news-bostonteaparty/	war-and-peace
/articles/historic-news-chemicalweapons-wwi/	war-and-peace
/articles/planets-orbitingsun/	science
/articles/sword-fighting/	sports
/articles/robotic-surgery/	science
/articles/moose-climatechange/	science
/articles/historic-news-californiagoldrush/	money
/articles/bison-history/	law
/articles/space-movie/	science
/articles/holocaust-newspaper/	war-and-peace
/articles/work-bias/	money
/articles/speeches-wiesel-indifference/	war-and-peace
/articles/speeches-chavez-mlk/	law
/articles/speeches-mandela-prisonrelease/	law
/articles/banana-apocalypse/	money
/articles/foodallergy-wealth/	health
/articles/bee-insecticide/	science
/articles/simple-cell/	opinion
/articles/historic-news-annexation-Texas-California/	war-and-peace
/articles/disney-findingdory/	science
/articles/trump-cruzquits/	law
/articles/tubman-jackson/	money
/articles/detroitschools-sickout/	kids
/articles/solarplane-pilots/	science
/articles/stephcurry-footwear/	money
/articles/sharks-glow/	science
/articles/maliaobama-harvard/	kids
/articles/historic-news-alamo/	war-and-peace
/articles/historic-news-eiffeltower/	science
/articles/chernobyl-nuclearplant/	science
/articles/spellingbee-harderwords/	kids
/articles/latinos-english/	law
/articles/testscores-mathreading/	kids
/articles/historic-news-lincolnassassination/	war-and-peace
/articles/ai-ethical/	opinion
/articles/currency-women/	law
/articles/vr-shopping/	money
/articles/capeivy-gallfly/	science
/articles/speeches-robespierre-terror/	law
/articles/feralcats-robotickillers/	science
/articles/trumpclinton-primaries/	law
/articles/recycling-economics/	money
/articles/baby-dinosaur/	science
/articles/historic-news-baberuth/	sports
/articles/historic-news-brooklynbridge/	science
/articles/cooking-class/	kids
/articles/sanfrancisco-embarcadero/	science
/articles/race-girls/	opinion
/articles/marine-debris/	science
/articles/historic-news-halleys-comet/	science
/articles/historic-news-butchcassidy/	war-and-peace
/articles/historic-news-trailoftears/	law
/articles/rio-flame/	sports
/articles/emoji-miscommunication/	science
/articles/females-hunting/	kids
/articles/urban-biodiversity/	science
/articles/speeches-carriecatt-suffrage/	law
/articles/speeches-roosevelt-unhumanrights/	law
/articles/historic-news-jimcrow/	law
/articles/historic-news-franzferdinand-WWI/	war-and-peace
/articles/historic-news-alaska-purchase-procon/	opinion
/articles/dinosaurs-asteroid/	science
/articles/flint-governor/	law
/articles/bancars-procon/	opinion
/articles/boaty-mcboatface/	science
/articles/prince-obit/	arts
/articles/affordable-electricity/	science
/articles/curry-mosquitonets/	sports
/articles/isis-youthsurvey/	war-and-peace
/articles/historic-news-transcontinental-railroad/	science
/articles/historic-news-shermansmarch/	war-and-peace
/articles/historic-news-mexicoinvasion/	war-and-peace
/articles/historic-news-hawaiiannexation/	war-and-peace
/articles/historic-news-torpedo/	war-and-peace
/articles/historic-news-edison/	science
/articles/speeches-chasesmith-declarationconscience/	law
/articles/speeches-troosevelt-meat/	law
/articles/speeches-lbj-civilrights/	law
/articles/rainbow-bagels/	arts
/articles/20bill-harriettubman/	money
/articles/arabic-flight/	war-and-peace
/articles/cocacola-smallcans/	money
/articles/jlin-foulcalls/	sports
/articles/spaceshuttle-tank/	science
/articles/whitehouse-sciencefair/	kids
/articles/chile-fossils/	science
/articles/newyork-primary/	law
/articles/math-brain/	science
/articles/pope-refugees/	war-and-peace
/articles/military-3dprinting/	war-and-peace
/articles/octopus-escape/	science
/articles/hemingway-jfk/	arts
/articles/brain-implant/	science
/articles/wwii-ship/	war-and-peace
/articles/spacestation-inflatable/	science
/articles/detroitschools-lead/	kids
/articles/kerry-hiroshima/	war-and-peace
/articles/royals-rhinopark/	law
/articles/speeches-amelia-earhart/	science
/articles/speeches-rfk-mlkassassination/	law
/articles/speeches-obama-dnckeynote/	war-and-peace
/articles/speeches-obama-inaugural/	war-and-peace
/articles/speeches-jfk-inaugural/	war-and-peace
/articles/speeches-fdroosevelt-inaugural/	war-and-peace
/articles/space-rna/	science
/articles/nc-governor/	law
/articles/taxidermy-class/	science
/articles/nflplayers-finance/	sports
/articles/chauvet-cave/	science
/articles/parrots-protection/	law
/articles/harrypotter-park/	money
/articles/future-telescope/	science
/articles/spain-siesta/	health
/articles/bangladeshi-surfgirls/	sports
/articles/cambodia-tigers/	science
/articles/librarycongress-aliens/	law
/articles/spacex-landing/	science
/articles/jackierobinson-pbs/	sports
/articles/tesla-envt/	money
/articles/nba-english/	sports
/articles/extinct-aurochs/	science
/articles/danceboy-adhd/	arts
/articles/arctic-cruise/	science
/articles/zooanimal-photos/	law
/articles/bat-wings/	science
/articles/young-reporter/	kids
/articles/civilwar-cemetery/	law
/articles/kingtut-mysteries/	war-and-peace
/articles/peru-counterfeitmoney/	money
/articles/oregonstandoff-wildlife/	science
/articles/joecrow-obit/	law
/articles/iran-dogsanctuary/	money
/articles/indonesia-hobbitfossils/	science
/articles/applefbi-procon/	opinion
/articles/seancombs-charterschool/	arts
/articles/kquinn-climateoped/	opinion
/articles/women-soccerwages/	sports
/articles/yosemite-cliffs/	science
/articles/un-debate/	law
/articles/sports-metrics/	sports
/articles/flotus-reachhigher/	opinion
/articles/recording-registry/	arts
/articles/spanish-language/	arts
/articles/soccer-unitesrefugees/	sports
/articles/syria-palmyra/	war-and-peace
/articles/crow-funerals/	science
/articles/cali-minwage/	money
/articles/peanuts-bolivia/	science
/articles/islandbluedolphins-petition/	arts
/articles/historic-news-sciam-southpole/	science
/articles/apple-fbi/	law
/articles/blackwomen-caucus/	law
/articles/pluto-newhorizons/	science
/articles/ireland-easterrising/	war-and-peace
/articles/instagram-generation/	money
/articles/historic-news-subway/	science
/articles/historic-news-gatling1872/	science
/articles/historic-news-peary-northpole/	science
/articles/historic-news-cloning/	science
/articles/historic-news-wrightbrothers/	science
/articles/historic-news-panamacanal/	science
/articles/historic-news-cottongin/	science
/articles/historic-news-sputnik/	science
/articles/historic-news-pasteur/	science
/articles/historic-news-titanic/	science
/articles/historic-news-curie/	science
/articles/lahore-easterattack/	war-and-peace
/articles/chicken-dinosaurlegs/	science
/articles/burundi-womensfootball/	sports
/articles/natural-gas/	science
/articles/pet-therapy/	health
/articles/speeches-washington-inaugural/	law
/articles/speeches-anthony-suffrage/	law
/articles/speeches-churchill-bloodsweattears/	war-and-peace
/articles/speeches-fdroosevelt-pearlharbor/	war-and-peace
/articles/speeches-reagan-challenger/	science
/articles/speeches-jfkennedy-moon/	science
/articles/speeches-obama-victory/	law
/articles/speeches-lincoln-gettysburg/	war-and-peace
/articles/speeches-douglass-slavery/	law
/articles/speeches-gandhi-quitindia/	war-and-peace
/articles/speeches-gwbush-911/	war-and-peace
/articles/speeches-phenry-libertydeath/	war-and-peace
/articles/malaysia370-debris/	law
/articles/manhole-art/	arts
/articles/diversity-smarts/	opinion
/articles/palestinian-teacher/	law
/articles/googledoodle-blm/	arts
/articles/newzealand-flag/	law
/articles/trex-ancestor/	science
/articles/cattle-thief/	money
/articles/generation-k/	money
/articles/canine-cancer/	health
/articles/kingtut-hiddenroom/	science
/articles/papuanewguinea-water/	health
/articles/dolphins-swimming/	science
/articles/japan-tsunamiorphans/	kids
/articles/cuba-soccerbaseball/	sports
/articles/obama-cubavisit/	law
/articles/brussels-attackswhy/	war-and-peace
/articles/tiger-recording/	science
/articles/vans-fashion/	money
/articles/teddybear-threatened/	law
/articles/brussels-attacks/	war-and-peace
/articles/mars-exploration/	science
/articles/hula-flowerfungus/	arts
/articles/snake-speed/	science
/articles/juvenile-prison/	kids
/articles/ice-timecapsule/	science
/articles/refugee-carepackage/	war-and-peace
/articles/blackathletes-graduation/	sports
/articles/princewilliam-wildlifetrafficking/	money
/articles/sharks-ultrasound/	health
/articles/yellowstone-supervolcano/	science
/articles/immigrantmothers-bookclub/	arts
/articles/seaworld-orcacaptivity/	money
/articles/mars-potatoes/	science
/articles/vets-allergies/	health
/articles/airportscreening-dogjobs/	money
/articles/fukushima-robots/	science
/articles/children-homealone/	kids
/articles/hoverboards-safetytesting/	law
/articles/plasticeating-bacteria/	science
/articles/scotus-garlandnominee/	law
/articles/winning-cheating/	opinion
/articles/processed-foods/	health
/articles/ohio17yo-primaryvoting/	law
/articles/americanballerina-russia/	arts
/articles/floridaohio-primary/	law
/articles/monarch-butterflies/	science
/articles/starbucks-italy/	money
/articles/trump-chicagoprotest/	law
/articles/ocean-noise/	science
/articles/owl-war/	science
/articles/myanmargenerals-democracy/	war-and-peace
/articles/americangirl-melody/	kids
/articles/jellyfish-app/	science
/articles/france-35hourweek/	money
/articles/farthest-galaxy/	science
/articles/sixyearold-noflylist/	law
/articles/pollinator-decline/	science
/articles/nairobi-atmwater/	money
/articles/texmex-colonialpageant/	arts
/articles/selfdrivingcars-procon/	opinion
/articles/womens-day/	law
/articles/whale-nighttime/	science
/articles/nasa-mars/	opinion
/articles/stlouis-lead/	health
/articles/chastain-brain/	sports
/articles/rhino-femalepatrol/	law
/articles/homeless-tinyhomes/	health
/articles/peytonmanning-retires/	sports
/articles/campaign-bullying/	kids
/articles/univision-trump/	law
/articles/mindcontrolled-prosthetic/	science
/articles/spacetwin-returns/	science
/articles/superheroes-girls/	money
/articles/nancyreagan-obituary/	law
/articles/animals-fearvanishing/	science
/articles/nature-fewkids/	kids
/articles/romney-trumpattack/	law
/articles/millennials-cereal/	money
/articles/defundsanctuaries-procon/	opinion
/articles/paintball-game/	law
/articles/whale-csi/	science
/articles/education-secretary/	kids
/articles/afghan-skull/	war-and-peace
/articles/teenage-wrestler/	sports
/articles/weevil-protein/	health
/articles/trump-insult/	science
/articles/pets-stemcelltherapy/	science
/articles/super-tuesday/	law
/articles/seaworld-spying/	law
/articles/target-genderneutral/	money
/articles/ucla-gymnast/	sports
/articles/hayden-librariancongress/	arts
/articles/women-boxing/	sports
/articles/ymca-slaveryactivity/	kids
/articles/pastafarian-id/	law
/articles/sc-demprimary/	law
/articles/space-tourism/	money
/articles/cottongin-history/	law
/articles/treblinka-lastsurvivor/	war-and-peace
/articles/britishactors-refugees/	arts
/articles/surfing-southafrica/	kids
/articles/scotus-termlimits/	law
/articles/solidarity-sharks/	opinion
/articles/china-statemedia/	law
/articles/flint-tapwater/	health
/articles/sharknet-safety/	science
/articles/mars-spacemates/	science
/articles/texas-gunsoncampus/	law
/articles/beluga-whales/	science
/articles/guantanamo-obamaplan/	war-and-peace
/articles/lordhowe-infestation/	science
/articles/house-cliff/	money
/articles/tribes-antelope/	science
/articles/india-watercrisis/	war-and-peace
/articles/urbanization-bacteria/	science
/articles/syrianconflict-stats/	war-and-peace
/articles/drones-safety/	law
/articles/harperlee-obit/	arts
/articles/chicago-shipmaster/	kids
/articles/mini-brains/	science
/articles/nepal-watercrisis/	health
/articles/scnevada-primary/	law
/articles/hawaii-coral/	science
/articles/longtown-racialharmony/	law
/articles/apple-encryption/	war-and-peace
/articles/voter-id/	law
/articles/emojis-communication/	arts
/articles/chicago-muslimyouth/	kids
/articles/colombia-spelling/	money
/articles/zika-mosquitoes/	health
/articles/prez-bilingual/	law
/articles/hockey-fighting/	sports
/articles/cursive-dying/	arts
/articles/animal-who/	opinion
/articles/lead-toxic/	health
/articles/robot-cockroaches/	science
/articles/kiva-microlending/	money
/articles/scalia-appointment/	law
/articles/gravity-physics/	science
/articles/college-admissions/	opinion
/articles/unitednations-reparations/	war-and-peace
/articles/trump-demeanor/	law
/articles/beyonce-superbowl/	arts
/articles/hispanicstudents-break/	kids
/articles/prezmedicalrecords-procon/	opinion
/articles/toy-expert/	money
/articles/racism-whiteattitudes/	law
/articles/china-salafism/	war-and-peace
/articles/yawning-contagious/	science
/articles/venetian-glass/	arts
/articles/prezbios-obama/	law
/articles/newhampshire-primary/	law
/articles/aiweiwei-denmarkprotest/	arts
/articles/centralpark-horses/	money
/articles/manatee-threatened/	science
/articles/refugee-tech/	opinion
/articles/seaworld-dolphins/	science
/articles/avalanche-education/	sports
/articles/medical-mysteries/	health
/articles/camnewton-quarterback/	sports
/articles/motorcycle-femaleowners/	money
/articles/syrianrefugee-education/	war-and-peace
/articles/activist-baltimoremayor/	law
/articles/nuclearpower-procon/	opinion
/articles/hoverboards-safety/	money
/articles/obama-mosquevisit/	law
/articles/schools-tests/	kids
/articles/southafrica-drought/	science
/articles/latino-vote/	law
/articles/computer-gogame/	science
/articles/autonomouscars-cities/	money
/articles/child-slavery/	opinion
/articles/lessons-youngscientists/	science
/articles/rosaparks-myths/	law
/articles/gerrymandering-redistricting/	law
/articles/barbie-body/	money
/articles/drytortugas-shipwreck/	science
/articles/iowacaucus-2016/	law
/articles/telenovela-kidneydonation/	health
/articles/treefrog-returns/	science
/articles/young-voters/	law
/articles/sundance-birthofanation/	arts
/articles/obama-solitaryconfinement/	law
/articles/dali-vr/	arts
/articles/doomsday-clock/	science
/articles/afterschool-program/	money
/articles/cigarette-buyingage/	health
/articles/clinton-celebrities/	law
/articles/juanes-johnlegend/	arts
/articles/quake-doomsday/	science
/articles/superbowl-homeless/	sports
/articles/challenger-anniversary/	science
/articles/basketball-mentors/	sports
/articles/ramsfootball-mansion/	money
/articles/girlscout-bball/	kids
/articles/coding-education/	money
/articles/kids-fairness/	kids
/articles/salem-witch/	law
/articles/michelleobama-lunchlegacy/	health
/articles/new-planet/	science
/articles/tomatopickers-humanrights/	kids
/articles/detroit-teachersickout/	law
/articles/lightsaber-class/	sports
/articles/scotus-immigration/	law
/articles/sealion-pups/	science
/articles/classicalmusic-students/	arts
/articles/projectsyndicate-chinachildpolicy/	opinion
/articles/frenchjews-skullcap/	war-and-peace
/articles/starwars-rey/	money
/articles/flint-residents/	law
/articles/gene-editingkit/	science
/articles/isolation-rooms/	kids
/articles/space-travel/	opinion
/articles/migration-southwest/	money
/articles/projectsyndicate-genemodify/	opinion
/articles/alanrickman-obit/	arts
/articles/jeremylin-oped/	opinion
/articles/neanderthal-genetics/	science
/articles/powerball-math/	opinion
/articles/la-ramsfootball/	sports
/articles/wolf-refuge/	science
/articles/taiwan-overseasvoters/	law
/articles/anthropocene-epoch/	science
/articles/ncaa-minoritycoaches/	sports
/articles/seaworld-whales/	money
/articles/hydrogen-diamond/	science
/articles/europe-biking/	sports
/articles/vet-entrepreneur/	money
/articles/obama-lastsotu/	law
/articles/periodictable-elements/	science
/articles/payphone-wifi/	money
/articles/beijing-airpurifiers/	health
/articles/dietary-guidelines/	health
/articles/projectsyndicate-education/	opinion
/articles/zika-virus/	health
/articles/agriscience-careers/	science
/articles/eatlessmeat-procon/	opinion
/articles/foodwaste-tech/	money
/articles/walmart-guns/	law
/articles/amazonbasin-conservation/	science
/articles/nkorea-nuclear/	war-and-peace
/articles/inuit-food/	health
/articles/eastasia-dogs/	science
/articles/capitol-dome/	law
/articles/obama-guncontrol/	law
/articles/soft-socialskills/	kids
/articles/projectsyndicate-racismhistory/	opinion
/articles/bratzdolls-comeback/	money
/articles/colorblind-glasses/	science
/articles/oregon-occupy/	law
/articles/guinea-ebolafree/	health
/articles/malaria-forests/	science
/articles/greenland-iceloss/	science
/articles/tanningbeds-ban/	health
/articles/straydog-police/	law
/articles/snowstorm-tech/	money
/articles/lebron-activism/	sports
/articles/cordcutting-biz/	money
/articles/recycling-procon/	opinion
/articles/401k-literacy/	money
/articles/onemillion-migrants/	war-and-peace
/articles/seattle-sleepystudents/	law
/articles/basketball-inventor/	sports
/articles/superintendent-poorschools/	kids
/articles/canada-aboriginals/	law
/articles/sealions-braindamage/	science
/articles/barbie-stem/	money
/articles/civilwar-blacksoldiers/	war-and-peace
/articles/americanjewish-soldier/	war-and-peace
/articles/affirmativeaction-research/	opinion
/articles/millennials-charity/	money
/articles/motherteresa-sainthood/	law
/articles/school-threats/	law
/articles/arctic-barriers/	science
/articles/headscarves-harassment/	law
/articles/hoverboards-flamingout/	money
/articles/rejectrefugees-procon/	opinion
/articles/politics-longevity/	law
/articles/hsgrad-rates/	kids
/articles/hijab-boxing/	sports
/articles/syrianrefugee-christmasgermany/	war-and-peace
/articles/twitter-nicebot/	law
/articles/brain-gender/	science
/articles/sikh-islamsolidarity/	law
/articles/paris-climateagreement/	science
/articles/toyota-robots/	money
/articles/schools-earthquake/	science
/articles/teens-exercise/	health
/articles/hashtag-staymadabby/	law
/articles/computing-elemschool/	kids
/articles/girlscout-woes/	money
/articles/globalwarming-entangledwhales/	science
/articles/education-bill/	kids
/articles/aztec-discovery/	science
/articles/youtube-streaming/	money
/articles/hackable-barbie/	law
/articles/beijing-smog/	health
/articles/automobile-future/	money
/articles/american-muslims/	war-and-peace
/articles/vultures-conservation/	law
/articles/trump-muslimban/	law
/articles/girlscouts-stem/	science
/articles/mountainlions-dying/	science
/articles/alaska-nativefood/	health
/articles/obama-ovalspeech/	war-and-peace
/articles/gmo-salmon/	health
/articles/sanders-snapchat/	money
/articles/gene-editing/	opinion
/articles/military-women/	war-and-peace
/articles/projectsyndicate-poaching/	opinion
/articles/slaves-nestle/	money
/articles/referees-hostility/	sports
/articles/sanbernardino-shooting/	law
/articles/elnino-global/	science
/articles/zuckerberg-donation/	money
/articles/underarmour-biz/	money
/articles/southcarolina-campaign/	law
/articles/mosquitoes-fighting/	science
/articles/artifacts-tour/	arts
/articles/whiterhino-euthanized/	science
/articles/chicagopolice-chief/	law
/articles/school-garden/	kids
/articles/deported-bedtimestories/	law
/articles/groundwater-earthcrust/	science
/articles/kobebryant-retire/	sports
/articles/braingames-adhd/	science
/articles/seattle-gumwall/	arts
/articles/distracted-biking/	sports
/articles/migrants-annefrank/	war-and-peace
/articles/mall-santa/	money
/articles/states-recycling/	law
/articles/coupon-democracy/	law
/articles/isisattack-procon/	opinion
/articles/sacred-bear/	science
/articles/collegecampus-unrest/	law
/articles/civilrights-police/	law
/articles/refugee-history/	war-and-peace
/articles/alien-immigrationlanguage/	law
/articles/election-minwage/	money
/articles/tapeworm-cancer/	health
/articles/republicangovernors-refugees/	war-and-peace
/articles/japaneseball-league/	sports
/articles/projectsyndicate-labor/	opinion
/articles/elfaro-shipwreck/	science
/articles/mali-attack/	war-and-peace
/articles/trump-immigration/	law
/articles/crabs-toxic/	science
/articles/bandit-seaslugs/	science
/articles/parisattacks-explainkids/	war-and-peace
/articles/rockstar-energydrink/	health
/articles/publichousing-smokingban/	health
/articles/projectsyndicate-droneprivacy/	opinion
/articles/boxing-rousey/	sports
/articles/storycorps-interview/	kids
/articles/friction-experiment/	science
/articles/cdc-obesity/	health
/articles/parisattack-socialmedia/	opinion
/articles/dogs-criminaljustice/	law
/articles/firstgen-collegestudents/	money
/articles/deaf-bizowners/	money
/articles/missouri-footballpower/	sports
/articles/hiring-formerfelons/	law
/articles/toysales-comeback/	money
/articles/sesamestreet-autism/	health
/articles/paris-attacks/	war-and-peace
/articles/no-homework/	kids
/articles/syrian-swimmers/	sports
/articles/footballplayer-artist/	sports
/articles/russia-doping/	sports
/articles/foodlabel-procon/	opinion
/articles/drought-bearinvasion/	science
/articles/beef-grassfed/	health
/articles/seaworld-orca/	money
/articles/sweden-poverty/	law
/articles/mars-farm/	science
/articles/electric-eels/	science
/articles/missouri-football/	sports
/articles/gaga-ball/	sports
/articles/teen-nasajob/	kids
/articles/oregon-plague/	science
/articles/keystone-oilpipeline/	science
/articles/syriawar-poetry/	war-and-peace
/articles/calorie-labels/	health
/articles/africa-lions/	science
/articles/adidas-mascots/	sports
/articles/obama-music/	arts
/articles/afghanboy-surgery/	health
/articles/alaska-wolves/	science
/articles/foodborne-outbreaks/	health
/articles/projectsyndicate-bottledwater/	opinion
/articles/space-bacteria/	science
/articles/medicaid-fosteryouth/	health
/articles/youthlawsuit-climate/	kids
/articles/countrymusic-nyc/	arts
/articles/asian-modelminority/	law
/articles/projectsyndicate-africadrones/	opinion
/articles/rockmusic-college/	arts
/articles/frog-extinction/	science
/articles/processedmeat-cancer/	health
/articles/schoolelection-diversity/	kids
/articles/ryan-housespeaker/	law
/articles/copeland-balletfame/	arts
/articles/seed-vault/	science
/articles/fish-waste/	health
/articles/china-childpolicy/	law
/articles/harvarddebate-versusinmates/	law
/articles/hawaii-homeless/	law
/articles/city-rats/	health
/articles/syria-depopulation/	war-and-peace
/articles/earth-earliestlife/	science
/articles/schighschool-student/	law
/articles/china-tinypigs/	science
/articles/schools-testing/	kids
/articles/suspension-policies/	law
/articles/halloween-biz/	money
/articles/ap-courses/	kids
/articles/hurricane-patricia/	science
/articles/noredskins-schools/	sports
/articles/uschina-ivoryban/	money
/articles/projectsyndicate-foodwaste/	opinion
/articles/michelleobama-pakistan/	war-and-peace
/articles/tesla-autopilot/	science
/articles/india-nodoors/	law
/articles/rangerschool-thirdwoman/	war-and-peace
/articles/japan-pow/	war-and-peace
/articles/camden-hackathon/	kids
/articles/projectsyndicate-eduemergencies/	opinion
/articles/projectsyndicate-gates/	opinion
/articles/science-film/	arts
/articles/17century-selfies/	arts
/articles/teen-republican/	kids
/articles/clinton-youngimmigrant/	law
/articles/mcdonalds-eggs/	money
/articles/chernobyl-wildlife/	science
/articles/iran-nuclear/	war-and-peace
/articles/elephant-cancer/	health
/articles/exoticpets-laws/	law
/articles/fantasysports-legality/	sports
/articles/drones-agriculture/	science
/articles/iraq-braindrain/	war-and-peace
/articles/afghanistan-ustroops/	war-and-peace
/articles/london-cerealcafe/	money
/articles/beluga-aquarium/	science
/articles/democrats-minwage/	money
/articles/zipline-injuries/	sports
/articles/british-baker/	arts
/articles/gilgamesh-lines/	science
/articles/cooking-nun/	arts
/articles/lego-castle/	arts
/articles/nobelpeace-tunisia/	war-and-peace
/articles/millennials-news/	money
/articles/telemedicine-growth/	health
/articles/japan-nuclearchildren/	health
/articles/asian-immigration/	law
/articles/driverless-car/	money
/articles/nobel-chemistry/	science
/articles/ebola-doctor/	science
/articles/streetart-humanrights/	arts
/articles/textbook-complaint/	kids
/articles/migrants-techsavvy/	science
/articles/rodeo-horse/	sports
/articles/vw-dealers/	money
/articles/sandersclinton-fundraising/	money
/articles/cdc-fastfood/	health
/articles/monkey-selfie/	law
/articles/ahmed-clockteacher/	kids
/articles/microsoft-africa/	money
/articles/tooth-enamel/	science
/articles/obama-oregonshooting/	law
/articles/standing-desks/	kids
/articles/mapuche-culture/	arts
/articles/egypt-antiquities/	arts
/articles/return-trip/	science
/articles/elnino-snakes/	science
/articles/uscuba-farmers/	money
/articles/mars-liquidwater/	science
/articles/exercise-brainbenefits/	sports
/articles/tibet-princess/	war-and-peace
/articles/africa-outlook/	money
/articles/diving-dancers/	arts
/articles/syria-chicago/	war-and-peace
/articles/exotic-pets/	money
/articles/esports-popular/	sports
/articles/israel-christianschools/	kids
/articles/yogiberra-obit/	sports
/articles/saudi-women/	money
/articles/brain-tricks/	science
/articles/boehner-resignation/	law
/articles/chess-cheating/	science
/articles/europemigrant-minors/	war-and-peace
/articles/anthropology-trash/	money
/articles/millennials-online/	kids
/articles/plastic-turtles/	science
/articles/cruz-teen/	law
/articles/kerry-refugees/	war-and-peace
/articles/obesity-genetics/	health
/articles/virginia-confederate/	law
/articles/pope-schoolvisit/	kids
/articles/themepark-animalresearch/	science
/articles/homeless-sign/	arts
/articles/chile-quake/	science
/articles/mountain-lions/	science
/articles/football-virtualreality/	sports
/articles/student-clock/	kids
/articles/dance-exercise/	sports
/articles/robot-wars/	science
/articles/hypercane-forecast/	science
/articles/afghanistan-streetart/	war-and-peace
/articles/la-olympics/	sports
/articles/nyfw-nepal/	arts
/articles/victorianera-blacks/	arts
/articles/colorado-drought/	science
/articles/cradle-fossils/	science
/articles/family-band/	arts
/articles/southafrica-rhino/	science
/articles/germanschools-refugees/	kids
/articles/blind-echolocation/	health
/articles/walrus-alaska/	science
/articles/emmetttill-anniversary/	law
/articles/countrymusic-women/	arts
/articles/food-taste/	science
/articles/japan-refugees/	war-and-peace
/articles/cloud-whitener/	science
/articles/himalayas-earthquake/	science
/articles/caribbean-seaweed/	science
/articles/chongqing-wwii/	war-and-peace
/articles/trophyhunting-research/	money
/articles/latinos-katrina/	money
/articles/military-dogs/	health
/articles/worm-health/	science
/articles/migrants-hungary/	war-and-peace
/articles/cancer-veteran/	health
/articles/spain-jews/	war-and-peace
/articles/india-tb/	health
/articles/gaming-learning/	science
/articles/disney-shanghai/	money
/articles/france-migrantschool/	war-and-peace
/articles/stemcells-sports/	sports
/articles/obama-mckinley/	law
/articles/poverty-braindevelopment/	health
/articles/preschool-seniorcitizens/	kids
/articles/mongolia-media/	arts
/articles/congo-gorillas/	science
/articles/highschool-seniordefense/	kids
/articles/latinos-middleclass/	money
/articles/drones-wildfires/	science
/articles/europe-ac/	money
/articles/panda-births/	science
/articles/lebanon-trashcrisis/	war-and-peace
/articles/britain-palace/	arts
/articles/thailand-pirates/	law
/articles/france-legionhonor/	war-and-peace
/articles/china-graveyard/	money
/articles/northkorea-statues/	arts
/articles/sushi-gendergap/	arts
/articles/uber-children/	kids
/articles/seabed-mining/	science
/articles/armyranger-female/	war-and-peace
/articles/mexico-tv/	money
/articles/mosquito-butterflies/	science
/articles/colorado-mining/	science
/articles/mideast-foodculture/	money
/articles/stateparks-kidappeal/	health
/articles/china-parkour/	sports
/articles/sanctuary-cities/	law
/articles/southafrica-owls/	science
/articles/northkorea-timezone/	war-and-peace
/articles/ecuador-happiness/	health
/articles/breakfast-skip/	science
/articles/jordan-refugeecity/	war-and-peace
/articles/mlk-practicespeech/	arts
/articles/children-reading/	science
/articles/carter-cancer/	health
/articles/puertorico-economy/	money
/articles/corn-history/	science
/articles/nefertiti-tomb/	science
/articles/textbook-civilwar/	kids
/articles/lebanon-trash/	war-and-peace
/articles/ferguson-oneyear/	law
/articles/afghanistan-toygun/	war-and-peace
/articles/invasive-worm/	science
/articles/hate-symbols/	war-and-peace
/articles/insulin-pills/	health
/articles/teen-pilots/	kids
/articles/gop-debate/	law
/articles/soccerhighschool-concussion/	sports
/articles/latinos-policeshootings/	law
/articles/malaysia-wingflap/	law
/articles/tribeconflict-coal/	money
/articles/shark-bites/	science
/articles/snowden-hiding/	war-and-peace
/articles/mthelens-glacier/	science
/articles/haitian-migrants/	law
/articles/nfl-femalecoach/	sports
/articles/pluto-flyby/	science
/articles/native-healthcenter/	health
/articles/jamestown-discovery/	science
/articles/indian-earcleaner/	health
/articles/hawaii-mountain/	arts
/articles/winterolympics-beijing/	sports
/articles/baby-chimp/	science
/articles/family-detention/	law
/articles/africa-lionhunting/	law
/articles/cuba-college/	money
/articles/baltimore-photog/	arts
/articles/deflategate-appeal/	sports
/articles/latino-census/	law
/articles/cuttlefish-camouflage/	science
/articles/italy-olives/	science
/articles/railroad-chineseworkers/	money
/articles/vintage-cars/	arts
/articles/coding-camp/	kids
/articles/eggs-organic/	money
/articles/drone-farms/	science
/articles/tropical-dinosaurs/	science
/articles/oreo-thins/	money
/articles/mars-glass/	science
/articles/bangladesh-antipoverty/	health
/articles/food-snobs/	health
/articles/sesamestreet-preschool/	kids
/articles/greecedebt-germany/	money
/articles/copeland-ballet/	arts
/articles/malala-sanjose/	war-and-peace
/articles/alamo-heritage/	arts
/articles/family-camping/	kids
/articles/church-fires/	law
/articles/schoolbus-fees/	money
/articles/bonneted-bat/	science
/articles/utah-drought/	science
/articles/christie-presannounce/	law
/articles/picky-eaters/	kids
/articles/earthquake-engineer/	science
/articles/kennewick-man/	science
/articles/mctscotus-gaymarriage/	law
/articles/vr-boom/	money
/articles/valedict-aspergers/	kids
/articles/lead-violence/	science
/articles/scotus-healthcare/	law
/articles/india-childlabor/	law
/articles/fern-crisis/	science
/articles/teacher-shakespeare/	kids
/articles/drought-shame/	law
/articles/rooftop-farms/	science
/articles/minwage-effect/	money
/articles/confederate-flag/	law
/articles/eggprices-rising/	money
/articles/pakistan-polio/	health
/articles/city-trolley/	money
/articles/10dollarbill-woman/	money
/articles/paper-yearbooks/	kids
/articles/charleston-shooting/	law
/articles/autism-prom/	kids
/articles/diverse-barbie/	kids
/articles/jeb-presannounce/	law
/articles/fosterkids-mentors/	kids
/articles/washington-drought/	science
/articles/naacp-ethnicity/	law
/articles/museums-selfies/	arts
/articles/dumpling-index/	arts
/articles/isis-antiquities/	war-and-peace
/articles/china-ivory/	money
/articles/mindful-athlete/	health
/articles/skorea-mers/	science
/articles/vision-literacy/	health
/articles/korean-language/	kids
/articles/terror-messaging/	war-and-peace
/articles/disney-costumes/	kids
/articles/writing-therapy/	arts
/articles/texaspool-incident/	law
/articles/malala-shooters/	war-and-peace
/articles/beijing-smokingban/	health
/articles/scotus-jerusalem/	war-and-peace
/articles/slaveship-artifacts/	science
/articles/themepark-foodapps/	money
/articles/slager-indictment/	law
/articles/goodall-book/	kids
/articles/brain-creativity/	science
/articles/perry-presannounce/	law
/articles/autism-chairbiz/	money
/articles/compsci-women/	science
/articles/blatter-resigns/	sports
/articles/beehealth-strategy/	science
/articles/military-bases/	war-and-peace
/articles/scotus-hijab/	law
/articles/sewage-drinkingwater/	health
/articles/botany-students/	science
/articles/chinaboat-sinks/	science
/articles/calitrain-cheaptix/	money
/articles/servicedogs-farms/	health
/articles/surveillancelaw-expired/	war-and-peace
/articles/homelessrising-losangeles/	law
/articles/france-unequalschools/	kids
/articles/fifa-sponsors/	sports
/articles/nativeschools-crumbling/	kids
/articles/nail-chemicals/	health
/articles/ireland-gaymarriage/	law
/articles/filmtax-creditcut/	money
/articles/emergencyresponse-robots/	science
/articles/cleveland-policesettlement/	law
/articles/johnnash-obit/	science
/articles/concussion-academicproblems/	health
/articles/wtc-elevator/	science
/articles/veggieprices-rising/	money
/articles/samuelclemens-angelscamp/	arts
/articles/boyscouts-gayleaders/	law
/articles/morro-rock/	law
/articles/israelipalestinian-soccer/	sports
/articles/chicagomayor-youthaddress/	law
/articles/lemonade-biz/	money
/articles/specialneeds-athletes/	sports
/articles/la-minwage/	money
/articles/southchinasea-coral/	war-and-peace
/articles/dolphins-solomonislands/	law
/articles/nba-lottery/	sports
/articles/obesity-graduation/	kids
/articles/singlesex-colleges/	money
/articles/morsi-deathsentence/	war-and-peace
/articles/bbking-obit/	arts
/articles/germany-refugees/	war-and-peace
/articles/tsarnaev-deathpenalty/	law
/articles/galaxy-distance/	science
/articles/popmusic-evolution/	arts
/articles/amtrak-crash/	law
/articles/brassband-female/	arts
/articles/cuba-hershey/	money
/articles/obamalibrary-chicagodecision/	law
/articles/alienplanet-swim/	science
/articles/liberia-ebolafree/	health
/articles/brady-deflategate/	sports
/articles/hamburger-uni/	money
/articles/kansas-fishing/	sports
/articles/myanmar-migrants/	war-and-peace
/articles/whales-entangled/	science
/articles/china-drumtower/	arts
/articles/bodycamera-price/	law
/articles/northdakota-oilslump/	money
/articles/swim-pollutedwater/	science
/articles/minoritygap-youngmen/	kids
/articles/music-earplugs/	arts
/articles/baby-usetech/	kids
/articles/huckabee-presannounce/	law
/articles/kraft-yellowdye/	science
/articles/woolly-mammoth/	science
/articles/nepalquake-animals/	law
/articles/school-breakfast/	kids
/articles/catalina-sinking/	science
/articles/fiorinacarson-presannounce/	law
/articles/graffiti-park/	arts
/articles/arctic-waves/	science
/articles/baltimore-baseball/	sports
/articles/urban-fruit/	health
/articles/usc-blindfan/	sports
/articles/sanders-presannounce/	law
/articles/colombia-indigenous/	law
/articles/baker-worldwarii/	arts
/articles/millennials-justicesurvey/	law
/articles/pencil-project/	kids
/articles/blob-warmwater/	science
/articles/baltimore-riot/	law
/articles/japan-smallschools/	kids
/articles/museums-chinesetourists/	arts
/articles/italy-migrants/	law
/articles/rescue-apps/	science
/articles/drought-jobs/	money
/articles/nepal-quake/	science
/articles/dog-gaze/	science
/articles/china-internet/	law
/articles/obama-everglades/	law
/articles/obama-armenia/	war-and-peace
/articles/jupiter-earth/	science
/articles/education-theft/	law
/articles/southafrica-immigration/	law
/articles/brain-learning/	science
/articles/pelicans-rehab/	science
/articles/pewsurvey-christianity/	law
/articles/water-recycle/	law
/articles/shakespeare-analysis/	arts
/articles/janitor-award/	kids
/articles/libya-boatcapsize/	law
/articles/myanmar-sidecar/	money
/articles/kansas-welfarerestriction/	law
/articles/hscivics-procon/	opinion
/articles/student-testing/	kids
/articles/dinosaur-find/	science
/articles/cuba-terrorismlist/	war-and-peace
/articles/navy-dolphin/	science
/articles/chuckecheese-adults/	money
/articles/diet-soda/	health
/articles/marktwain-newspaper/	money
/articles/alaskan-13yo/	money
/articles/lincoln-history/	law
/articles/cave-recreation/	arts
/articles/bostonmarathon-artist/	arts
/articles/rubio-presannounce/	law
/articles/saudiwomen-rideshareapp/	money
/articles/20dollarbill-female/	money
/articles/snake-bite/	science
/articles/clinton-presannounce/	law
/articles/starfish-deaths/	science
/articles/club-sports/	sports
/articles/courtroom-artist/	arts
/articles/ncharleston-mayor/	law
/articles/navajo-junkfood/	health
/articles/brontosaurus-returns/	science
/articles/tabletennis-middleschoolers/	sports
/articles/ferguson-citycouncil/	law
/articles/artist-housing/	arts
/articles/mrsa-medieval/	science
/articles/paul-presannounce/	law
/articles/scienceart-institute/	science
/articles/dare-dictionary/	money
/articles/mcdonalds-wage/	money
/articles/fisherman-found/	sports
/articles/karate-80yo/	sports
/articles/atlanta-teachers/	law
/articles/piano-upswing/	money
/articles/juvenile-court/	kids
/articles/cali-water/	law
/articles/jayz-tidal/	money
/articles/slavery-memorial/	arts
/articles/nigeria-president/	law
/articles/city-kids/	kids
/articles/richardiii-debate/	war-and-peace
/articles/indiana-law/	law
/articles/doodler-nebraskalawmaker/	arts
/articles/astronaut-twins/	science
/articles/ebola-mutation/	science
/articles/procon-ecigs/	opinion
/articles/schoollunch-chef/	kids
/articles/sumo-kids/	sports
/articles/math-visual/	kids
/articles/mars-finalist/	science
/articles/songs-preserve/	arts
/articles/supertide-abbey/	science
/articles/obama-stem/	law
/articles/pakistan-teacher/	kids
/articles/knitting-teens/	kids
/articles/whale-ancient/	science
/articles/farmworkers-mexico/	law
/articles/planecrash-frenchalps/	money
/articles/nationalpark-costs/	law
/articles/music-prodigy/	arts
/articles/cereal-salesslump/	money
/articles/cruz-presannounce/	law
/articles/boston-olympicbid/	sports
/articles/manatee-florida/	science
/articles/Obama-girlsschooling/	kids
/articles/clippers-college/	sports
/articles/wyoming-devilstower/	science
/articles/cigarette-packaging/	law
/articles/borland-footballretire/	sports
/articles/sugar-label/	law
/articles/suffrage-museum/	law
/articles/german-obituaries/	kids
/articles/nasa-ferry/	science
/articles/climate-mummies/	science
/articles/hellobarbie-privacy/	law
/articles/japanese-oysters/	money
/articles/snapchat-valuation/	money
/articles/haiti-teacher/	kids
/articles/children-centralamerica/	law
/articles/arthropod-fossil/	science
/articles/lonewoman-island/	science
/articles/lapd-helicopters/	law
/articles/digitalcontent-teenhabits/	arts
/articles/worldwomen-rights/	law
/articles/cave-cleaning/	science
/articles/afghan-taxidriver/	law
/articles/ferguson-shooting/	law
/articles/blind-swimmer/	sports
/articles/farm-photographer/	arts
/articles/shark-migration/	science
/articles/dominicanrepublic-baseball/	sports
/articles/disney-frozen/	money
/articles/ceres-dwarfplanet/	science
/articles/schoollunch-standards/	law
/articles/persiangulf-coral/	science
/articles/athletes-yips/	sports
/articles/obama-girlseducation/	law
/articles/turf-health/	sports
/articles/cuba-entrepreneurs/	money
/articles/russia-worldcup/	sports
/articles/ferguson-report/	law
/articles/polarbears-environment/	science
/articles/alaska-nativesurvivors/	health
/articles/obama-policetaskforce/	law
/articles/evolution-animalsbigger/	science
/articles/miami-searise/	science
/articles/dress-color/	science
/articles/russianconductor-politics/	arts
/articles/animation-bighero6/	arts
/articles/climate-surfing/	sports
/articles/nemtsov-march/	war-and-peace
/articles/colombian-avocado/	money
/articles/uncletom-dc/	law
/articles/everest-sherpas/	sports
/articles/highseas-regulate/	science
/articles/china-kitemakers/	arts
/articles/fourthgrade-sports/	sports
/articles/fatherdaughter-dance/	kids
/articles/nascar-schools/	sports
/articles/turkey-education/	law
/articles/femaleengineer-cars/	money
/articles/lunchseat-shuffle/	kids
/articles/cheerleader-downssyndrome/	kids
/articles/firstlady-education/	kids
/articles/blackgrads-jobs/	money
/articles/sledding-ban/	law
/articles/lincoln-library/	law
/articles/civilrights-music/	arts
/articles/popcorn-physics/	science
/articles/blind-speller/	kids
/articles/mexicolabor-retailer/	money
/articles/iraq-books/	war-and-peace
/articles/chinese-themepark/	money
/articles/preslibrary-land/	law
/articles/fake-leonardo/	arts
/articles/hawaii-philosophical/	science
/articles/samesexmarriage-alabama/	law
/articles/antelopevalley-bomber/	war-and-peace
/articles/chimps-grunts/	science
/articles/rosaparks-journal/	law
/articles/hispanics-education/	law
/articles/africanimmigrants-educated/	law
/articles/workers-skills-procon/	opinion
/articles/colombia-flowers/	money
/articles/asia-ozone/	health
/articles/orca-protect/	science
/articles/food-dna/	science
/articles/brianwilliams-suspend/	money
/articles/income-sports/	sports
/articles/capitol-music/	money
/articles/michelleobama-obesityfunding/	health
/articles/vertical-gardens/	science
/articles/sick-sealions/	science
/articles/unitedway-reading/	kids
/articles/measles-babies/	health
/articles/police-youth-talking/	law
/articles/iraqis-usasylum/	war-and-peace
/articles/shrinking-snowpack/	science
/articles/france-suburbs/	war-and-peace
/articles/future-farmers/	kids
/articles/iraq-libraries/	war-and-peace
/articles/mockingbird-sequel/	arts
/articles/videogames-health/	health
/articles/marine-wilderness/	science
/articles/venezuela-socialism/	law
/articles/youngnfl-injuries/	sports
/articles/english-spelling/	law
/articles/ferguson-pompomteam/	sports
/articles/yosemite-fox/	science
/articles/health-careers/	health
/articles/military-schools/	kids
/articles/Civilrights-comicbook/	arts
/articles/deflate-gate/	sports
/articles/civilrights-conviction/	law
/articles/pizza-obesity/	health
/articles/turtle-navigation/	science
/articles/measles-disney/	health
/articles/hunting-drones/	sports
/articles/civics-test/	law
/articles/compton-talentagents/	kids
/articles/muslim-challenges/	war-and-peace
/articles/northeast-storm/	money
/articles/bakery-autism/	money
/articles/textbooks-venezuela/	kids
/articles/volcano-scrolls/	science
/articles/suspension-policy/	kids
/articles/fish-glasseye/	science
/articles/warmest-year/	science
/articles/foster-college/	kids
/articles/apple-artgallery/	arts
/articles/free-violin/	arts
/articles/foreignstudents-book/	kids
/articles/bird-rollercoaster/	science
/articles/potus-address/	law
/articles/Australia-troubledkids/	kids
/articles/juniperoserra-sainthood/	law
/articles/mariachi-kids/	arts
/articles/ferguson-museum/	arts
/articles/virtual-reality/	science
/articles/yosemite-climbers/	sports
/articles/parents-sports/	sports
/articles/chinesewomen-cigarettes/	health
/articles/distant-battle/	war-and-peace
/articles/orangutan-rights/	science
/articles/trail-angels/	sports
/articles/homeless-children/	law
/articles/hebdo-newedition/	arts
/articles/nfl-losangeles/	sports
/articles/britain-pooh/	kids
/articles/obama-communitycollege/	law
/articles/china-pollutionapp/	health
/articles/baller-bol/	sports
/articles/digital-librarycongress/	law
/articles/torturereport-procon/	opinion
/articles/autism-flying/	kids
/articles/girl-toys/	kids
/articles/cartoon-dangers/	war-and-peace
/articles/concussion-reststudy/	health
/articles/ancient-astronomy/	science
/articles/blind-goalball/	sports
/articles/utah-speedlimits/	law
/articles/longterm-englishlearners/	kids
/articles/diverse-congress/	war-and-peace
/articles/beaver-drought/	science
/articles/surfer-shark/	kids
/articles/navajo-coal/	money
/articles/airasia-crash/	money
/articles/soccer-club/	sports
/articles/afghan-hotdog/	money
/articles/starving-kids/	kids
/articles/doctor-dangerousneighborhood/	health
/articles/hungarian-shopping/	law
/articles/teen-jobs/	money
/articles/dairy-campaign/	money
/articles/sony-nkorea/	war-and-peace
/articles/migrantkids-uprooted/	kids
/articles/cuba-us/	war-and-peace
/articles/india-coffee/	money
/articles/oilprice-effects/	money
/articles/distracted-walkers/	law
/articles/solarenergy-kids/	kids
/articles/toy-injuries/	kids
/articles/agtech-food/	money
/articles/favela-olympics/	sports
/articles/drone-popularity/	money
/articles/hottest-chili/	science
/articles/robotics-math/	kids
/articles/cuban-crocodiles/	science
/articles/boston-timecapsule/	law
/articles/music-lightspeed/	arts
/articles/videogames-scholarships/	kids
/articles/protest-songs/	law
/articles/china-heat/	law
/articles/mars-water/	science
/articles/child-injuries/	health
/articles/dog-drinking/	science
/articles/schoollunch-fail/	kids
/articles/torture-report/	war-and-peace
/articles/condor-cameras/	science
/articles/chinese-exclusion/	law
/articles/water-california/	science
/articles/women-astronauts/	science
/articles/New-civilrights/	law
/articles/iraq-ballet/	kids
/articles/apple-breeders/	science
/articles/pearlharbor-survivors/	war-and-peace
/articles/desalination-drought/	science
/articles/Fastfood-calories/	health
/articles/obama-daughters/	kids
/articles/selfdriving-future/	money
/articles/africanamericans-russia/	war-and-peace
/articles/ebolatroops-procon/	opinion
/articles/lucy-qanda/	science
/articles/obama-policecameras/	law
/articles/Free-fashions/	kids
/articles/heavy-trucks/	money
/articles/muir-legacy/	law
/articles/virtual-lab/	science
/articles/englishlanguage-lying/	kids
/articles/ferguson-thanksgiving/	war-and-peace
/articles/barbie-engineer/	kids
/articles/thai-hungergames/	war-and-peace
/articles/guerrilla-farming/	science
/articles/ferguson-grandjury/	law
/articles/starfish-death/	science
/articles/prison-dance/	law
/articles/egg-fight/	law
/articles/teotihuacan-artifacts/	science
/articles/parkour-training/	sports
/articles/obama-immigration-speech/	law
/articles/dogs-elephantherding/	science
/articles/disney-airspace/	law
/articles/westcoast-warming/	science
/articles/chinese-homebuyers/	money
/articles/fit-christie/	law
/articles/dreamers-mexico/	law
/articles/class-sizes/	kids
/articles/Drone-sightings/	science
/articles/penguin-robot/	science
/articles/wallenda-math/	kids
/articles/border-debate/	law
/articles/ferguson-warning/	law
/articles/dogs-lives/	science
/articles/ash-borers/	science
/articles/us-climatechange/	law
/articles/comet-probe/	science
/articles/nfl-britain/	sports
/articles/poverty-safetynet/	law
/articles/student-tracking/	kids
/articles/music-streaming/	arts
/articles/drought-inequality/	science
/articles/lonesome-turtle/	science
/articles/late-medal/	war-and-peace
/articles/Braille-startup/	kids
/articles/faster-baseball/	sports
/articles/berlinwall-25yearslater/	war-and-peace
/articles/elsalvador-gold/	money
/articles/saudis-basketball/	sports
/articles/cook-comingout/	money
/articles/ebolaresponse-procon/	opinion
/articles/wallenda-tightrope/	arts
/articles/club-inclusion/	kids
/articles/turtles-florida/	science
/articles/concussion-kids/	sports
/articles/obama-lameduck/	law
/articles/republicans-congress/	law
/articles/hellokitty-40/	money
/articles/bat-survival/	science
/articles/atomettes-reunion/	war-and-peace
/articles/hawaii-lava/	science
/articles/lebron-championship/	sports
/articles/amish-health/	health
/articles/secretservice-dogs/	law
/articles/spaceplane-crash/	money
/articles/prison-literacy/	law
/articles/predatoryfish-decline/	science
/articles/navajo-language/	law
/articles/unc-cheating/	sports
/articles/bears-ballots/	law
/articles/nfl-investing/	sports
/articles/florida-honeybees/	law
/articles/canada-securitylaws/	war-and-peace
/articles/war-artifacts/	war-and-peace
/articles/library-homework/	kids
/articles/defining-refugees/	law
/articles/ballot-GMOs/	law
/articles/donation-homeless/	money
/articles/giant-pumpkins/	science
/articles/ebola-newyork/	health
/articles/drought-losangeles/	law
/articles/ottawa-attack/	war-and-peace
/articles/mummy-scans/	science
/articles/AsianAmericans-south/	law
/articles/Nigeria-ebolafree/	health
/articles/nfl-procon/	opinion
/articles/cuba-violins/	arts
/articles/iran-water/	money
/articles/drones-commercial/	money
/articles/carnegie-girlscience/	kids
/articles/sweden-submarine/	war-and-peace
/articles/confederateflag-art/	arts
/articles/temple-tourists/	arts
/articles/zoo-conservation/	science
/articles/ebola-schools/	health
/articles/captive-whales/	money
/articles/ferguson-agency/	law
/articles/heatstroke-students/	sports
/articles/rainier-lab/	science
/articles/landscape-art/	arts
/articles/King-nobelprize/	war-and-peace
/articles/ebola-math/	health
/articles/Indonesian-caveart/	science
/articles/timetravel-paradox/	science
/articles/polynesian-canoe/	science
/articles/ebola-nurse/	health
/articles/Nobel-peacewinner/	war-and-peace
/articles/walrus-ashore/	science
/articles/nobel-peace/	war-and-peace
/articles/ukraineaid-procon/	opinion
/articles/physics-nobel/	science
/articles/duncan-death/	health
/articles/juvenilehall-writers/	kids
/articles/ebola-airlines/	health
/articles/peru-gold/	arts
/articles/oil-whale/	science
/articles/hightech-hajj/	science
/articles/schools-coalcountry/	money
/articles/gaymarriage-scotus/	law
/articles/3D-limbs/	kids
/articles/politics-minimumwage/	money
/articles/texas-ebola/	health
/articles/campfire-stories/	science
/articles/waterless-communities/	money
/articles/pierson-resignation/	law
/articles/poverty-incomegap/	money
/articles/baseball-cuba/	sports
/articles/ebola-patient/	health
/articles/weapons-georgiaschools/	law
/articles/child-mortality/	health
/articles/child-rebels/	war-and-peace
/articles/healthylunch-procon/	opinion
/articles/f22-fighter/	war-and-peace
/articles/hongkong-protest/	war-and-peace
/articles/firstladies-libraries/	law
/articles/Detroit-bankruptcy/	money
/articles/agricultural-extensions/	money
/articles/syria-heritage/	war-and-peace
/articles/china-environment/	law
/articles/costudent-protests/	kids
/articles/yosemite-animals/	science
/articles/obama-unitednations/	war-and-peace
/articles/ebola-curfew/	health
/articles/mars-maven/	science
/articles/syria-strikes/	war-and-peace
/articles/yupik-treasures/	arts
/articles/junkfood-study/	health
/articles/popup-wetland/	science
/articles/digital-encyclopedia/	money
/articles/texas-immigrants/	kids
/articles/sixth-mass-extinction/	opinion
/articles/football-kidney/	sports
/articles/scotland-votes/	law
/articles/swimming-dinosaur/	science
/articles/hookah-teens/	health
/articles/senators-hometowns/	law
/articles/russia-ukrainianimmigrants/	war-and-peace
/articles/georgewashington-painting/	arts
/articles/scotland-generationgap/	law
/articles/vintage-baseball/	sports
/articles/sat-chinesestudents/	kids
/articles/somali-policewoman/	law
/articles/nativeamerican-diets/	health
/articles/madeline-75years/	kids
/articles/trigger-procon/	opinion
/articles/butterfly-gmos/	science
/articles/malala-shooting/	war-and-peace
/articles/arctic-permafrost/	science
/articles/healthcare-dogs/	health
/articles/germany-forger/	arts
/articles/Obama-Islamic-State/	war-and-peace
/articles/passenger-pigeons/	science
/articles/china-textiles/	money
/articles/ebola-response/	health
/articles/sleepy-students/	kids
/articles/gargantuan-dino/	science
/articles/mummies-age/	science
/articles/sapphire-apple/	money
/articles/ravens-termination/	sports
/articles/physics-monet/	arts
/articles/books-minecraft/	science
/articles/wolves-yawning/	science
/articles/amoeba-brain/	health
/articles/prison-design/	arts
/articles/chicago-schoolsafety/	law
/articles/flights-diverted/	law
/articles/deathvalley-rocks/	science
/articles/police-cameras/	law
/articles/mustangs-northcarolina/	law
/articles/sleepy-schooltimes/	kids
/articles/conservation-careers/	science
/articles/israelischool-children/	war-and-peace
/articles/headdress-twitter/	law
/articles/uzi-kids/	law
/articles/bacon-priceincrease/	money
/articles/racerelations-ferguson/	law
/articles/oil-ndnationalpark/	law
/articles/Ukraine-invasion/	war-and-peace
/articles/socialmedia-socialawareness/	kids
/articles/nfl-domesticviolence/	sports
/articles/bitcoin-teen/	kids
/articles/orioles-alvarez/	sports
/articles/lebanon-hiphop/	war-and-peace
/articles/indianartifacts-storms/	arts
/articles/napa-quake/	science
/articles/laschool-discipline/	kids
/articles/census-race/	law
/articles/english-laws/	law
/articles/icebucket-phenomenon/	health
/articles/food-danger/	health
/articles/immigration-harvest/	money
/articles/ferguson-ban/	kids
/articles/underwaterrobot-teens/	science
/articles/elephants-pittsburgh/	science
/articles/holder-letter/	law
/articles/military-police/	law
/articles/Wisconsin-earthquakes/	science
/articles/stamp-critics/	arts
/articles/wwi-arts/	arts
/articles/seaworld-orcas/	money
/articles/borderchildren-procon/	opinion
/articles/ferguson-natlguard/	law
/articles/littleleague-girls/	sports
/articles/goodschools-health/	health
/articles/ferguson-curfew/	law
/articles/panama-100/	science
/articles/gator-hunt/	sports
/articles/twitter-sports/	sports
/articles/yazidi-nebraska/	war-and-peace
/articles/smallworld-50/	kids
/articles/michaelbrown-twitter/	law
/articles/california-grizzlies/	science
/articles/tibetans-genes/	science
/articles/refugees-garden/	war-and-peace
/articles/rocket-docket/	kids
/articles/russia-sanctions/	money
/articles/ebola-soccer/	sports
/articles/musical-diplomacy/	arts
/articles/airstrikes-iraq/	war-and-peace
/articles/baseball-specialneeds/	sports
/articles/wwII-painter/	arts
/articles/global-hamlet/	arts
/articles/africa-economy/	money
/articles/crete-discovery/	science
/articles/book-bike/	arts
/articles/physics-animation/	science
/articles/dino-hunter/	science
/articles/Hospital-bootcamp/	kids
/articles/gaza-ceasefire/	war-and-peace
/articles/blackteachers-rolemodels/	kids
/articles/Fastfood-millennials/	health
/articles/kansas-roundup/	money
/articles/pga-moneyball/	sports
/articles/mexicanartists-taxtime/	arts
/articles/rip-currents/	science
/articles/ebola-health/	health
/articles/Teddyroosevelt-library/	law
/articles/beef-climatechange/	science
/articles/immigrantoverload-schools/	kids
/articles/gaza-fighting/	war-and-peace
/articles/nativeamerican-logo/	law
/articles/vetshelping-teens/	kids
/articles/israelipalestinian-coexistence/	war-and-peace
/articles/cleveland-lebron/	sports
/articles/grandcanyon-development/	science
/articles/malaysia-ukrainecrash/	war-and-peace
/articles/malala-nigeria/	war-and-peace
/articles/migrants-refugees/	law
/articles/earhart-clues/	science
/articles/orca-trouble/	science
/articles/soccer-procon/	opinion
/articles/free-lunch/	kids
/articles/georgia-schoolguns/	law
/articles/teen-poetry/	arts
/articles/potato-friends/	health
/articles/drones-privacy/	science
/articles/mexico-bullies/	kids
/articles/iraq-ramadan/	war-and-peace
/articles/girls-acl/	sports
/articles/soccer-immigrants/	kids
/articles/picasso-hiddenman/	arts
/articles/school-nurses/	health
/articles/worldcup-1950/	sports
/articles/sierra-calculus/	science
/articles/frog-tongues/	science
/articles/redskins-trademark/	sports
/articles/anthem-manuscript/	arts
/articles/coolkids-struggle/	kids
/articles/jogo-bonito/	sports
/articles/africa-entrepreneurs/	money
/articles/obama-sanctuary/	science
/articles/music-program/	kids
/articles/immigration-crisis/	law
/articles/harleys-thefts/	law
/articles/teen-clothiers/	money
/articles/ant-rafts/	science
/articles/camping-fires/	kids
/articles/cooking-literacy/	kids
/articles/ucla-mural/	arts
/articles/dye-library/	science
/articles/videogames-tuition/	money
/articles/slippery-rocksnot/	science
/articles/worldcup-start/	sports
/articles/invasive-lionfish/	science
/articles/ca-goldprospectors/	money
/articles/presidents-health/	law
/articles/Hurricane-drones/	science
/articles/Last-navajocodetalker/	war-and-peace
/articles/britainclassroom-struggle/	kids
/articles/basketball-data/	sports
/articles/chinook-recognition/	law
/articles/zebra-migration/	science
/articles/D-day-fallen/	war-and-peace
/articles/txgun-rallies/	law
/articles/world-obesity/	health
/articles/koala-trees/	science
/articles/google-selfcars/	money
/articles/overseas-filmscoring/	money
/articles/sjstate-space/	science
/articles/kennewick-skeleton/	science
/articles/bergdahl-release/	war-and-peace
/articles/rainier-allure/	science
/articles/concussion-study/	health
/articles/memory-competition/	sports
/articles/obama-lunchresponse/	kids
/articles/spain-abdication/	war-and-peace
/articles/whale-freed/	science
/articles/richardiii-burial/	war-and-peace
/articles/apple-beats/	money
/articles/disney-pricehikes/	money
/articles/spelling-bee/	kids
/articles/summer-hunger/	kids
/articles/obama-westpoint/	war-and-peace
/articles/beneath-sthelens/	science
/articles/realtor-drones/	money
/articles/angelou-obit/	arts
/articles/pope-israel/	war-and-peace
/articles/mexico-exchange/	war-and-peace
/articles/groundwater-earthquakes/	science
/articles/yucatan-sanfrancisco/	law
/articles/happy-iran/	law
/articles/autism-ipads/	health
/articles/chad-nigeria/	war-and-peace
/articles/arts-education/	arts
/articles/dog-soldiers/	war-and-peace
/articles/teen-study/	kids
/articles/moveto-mars/	science
/articles/testtube-meat/	health
/articles/child-soldiers/	war-and-peace
/articles/wolf-love/	kids
/articles/iran-soccer/	sports
/articles/antarctic-ice/	science
/articles/california-chrome/	sports
/articles/military-recruiting/	war-and-peace
/articles/medical-hackers/	science
/articles/naia-skeleton/	science
/articles/tobacco-picking/	kids
/articles/undocumented-family/	law
/articles/turkey-mining/	war-and-peace
/articles/socal-wildfires/	money
/articles/columbus-shipwreck/	war-and-peace
/articles/shark-catches/	law
/articles/asteroid-crowdsource/	science
/articles/lunch-standards/	kids
/articles/wooden-rollercoaster/	kids
/articles/bokoharam-video/	war-and-peace
/articles/ukraine-poverty/	war-and-peace
/articles/scjohnson-building/	arts
/articles/prom-draft/	kids
/articles/ag-education/	kids
/articles/statue-surgery/	arts
/articles/trekking-women/	money
/articles/farm-climatechange/	science
/articles/army-hair/	war-and-peace
/articles/durant-mvp/	sports
/articles/teachers-diversity/	kids
/articles/nigeria-kidnapping/	war-and-peace
/articles/minecraft-schools/	kids
/articles/kingsnake-canaryislands/	science
/articles/louvre-abudhabi/	arts
/articles/ukraine-struggle/	war-and-peace
/articles/bones-art/	arts
/articles/bison-grandcanyon/	science
/articles/bollywood-high/	kids
/articles/nutria-laststand/	science
/articles/two-dollarbill/	money
/articles/mtbaldy-geology/	science
/articles/smartphones-supremecourt/	law
/articles/bighorn-sheep/	science
/articles/gassavingcar-race/	science
/articles/auschwitz-palestine/	war-and-peace
/articles/atari-dig/	money
/articles/cubans-inventions/	money
/articles/warhol-disks/	arts
/articles/clippers-sterling/	sports
/articles/waterrights-fresno/	law
/articles/afghan-childlaborers/	kids
/articles/horseshoe-crabs/	science
/articles/tiananmen-square/	war-and-peace
/articles/sherpa-everest/	money
/articles/cat-apathy/	science
/articles/last-whalers/	money
/articles/wheelchair-rugby/	sports
/articles/teen-stowaway/	kids
/articles/india-cheating/	kids
/articles/earthlike-planet/	science
/articles/garimara-obituary/	law
/articles/sabbath-debate/	law
/articles/laboratory-noses/	science
/articles/corporal-punishment/	kids
/articles/soccer-atlanta/	sports
/articles/boston-marathon/	sports
/articles/hockey-lawsuit/	sports
/articles/digital-resistance/	law
/articles/afghan-painter/	arts
/articles/plane-submarine/	science
/articles/school-nogrades/	kids
/articles/nile-walking/	war-and-peace
/articles/ukrainian-eggs/	arts
/articles/monarch-crisis/	science
/articles/syria-aleppo/	war-and-peace
/articles/blackreporter-whitehouse/	law
/articles/mentalhealth-schoolviolence/	kids
/articles/tablets-kids/	kids
/articles/chimp-escape/	science
/articles/passover-shooting/	law
/articles/food-waste/	kids
/articles/obama-library/	law
/articles/fukushima-schools/	kids
/articles/afro-beauty/	kids
/articles/exporting-chihuahuas/	money
/articles/rwanda-genocide/	war-and-peace
/articles/nasa-ethics/	science
/articles/workers-fastfood/	money
/articles/drought-lawns/	science
/articles/chinese-farmers/	money
/articles/accordion-lessons/	kids
/articles/physics-prof/	science
/articles/fivesecond-rule/	health
/articles/microbes-extinction/	science
/articles/digital-pianos/	arts
/articles/feral-cats/	law
/articles/satellite-movies/	money
/articles/migrant-minors/	kids
/articles/bullying-popular/	kids
/articles/chinese-menus/	money
/articles/cuban-paper/	war-and-peace
/articles/woollymammoth-ribs/	science
/articles/panther-releases/	science
/articles/rosie-riveter/	war-and-peace
/articles/georgia-guns/	law
/articles/dog-cognition/	science
/articles/obama-cooking/	health
/articles/missing-plane/	war-and-peace
/articles/rocket-cats/	war-and-peace
/articles/collegesports-women/	sports
/articles/b2-resurrection/	war-and-peace
/articles/derby-dolls/	sports
/articles/3d-indoormap/	science
/articles/exxonvaldez-anniversary/	science
/articles/milk-trends/	health
/articles/mudslide-prediction/	science
/articles/dinosaur-colors/	science
/articles/bullfighting-teen/	sports
/articles/obama-WWI/	war-and-peace
/articles/syria-schoolchildren/	war-and-peace
/articles/milkyway-discovery/	science
/articles/school-suspensions/	kids
/articles/homework-burden/	kids
/articles/moving-home/	kids
/articles/shuttle-parts/	science
/articles/wars-procon/	opinion
/articles/norcal-quake/	science
/articles/chocolate-health/	health
/articles/leprosy-stigma/	health
/articles/buffett-marchmadness/	sports
/articles/bangladesh-women/	money
/articles/yurok-drugcourt/	law
/articles/veterans-medalofhonor/	war-and-peace
/articles/mystery-aircraft/	law
/articles/crimea-annex/	war-and-peace
/articles/LA-fossils/	science
/articles/pollock-myth/	arts
/articles/navajo-codetalkers/	war-and-peace
/articles/biblio-tech/	kids
/articles/teen-scientist/	science
/articles/genghiskhan-trees/	science
/articles/butterfly-genes/	science
/articles/malaysia-hijacking/	war-and-peace
/articles/alpaca-boom/	money
/articles/facebook-SAD/	science
/articles/la-ecigaretteban/	health
/articles/apple-itunes/	arts
/articles/students-drillteam/	kids
/articles/frozen-lakes/	science
/articles/Iditarod-finish/	sports
/articles/nano-silver/	science
/articles/mayors-spanish/	law
/articles/music-brain/	science
/articles/girlscouts-barbie/	kids
/articles/whales-space/	science
/articles/water-usage/	money
/articles/paralympic-superstar/	sports
/articles/malaysiaplane-fbi/	law
/articles/zircon-discovery/	science
/articles/SAT-changes/	kids
/articles/tatar-history/	war-and-peace
/articles/rap-art/	arts
/articles/homeless-students/	money
/articles/cell-printing/	science
/articles/nutrition-labels/	health
/articles/dental-dna/	science
/articles/everest-litterbugs/	law
/articles/kepler-planets/	science
/articles/parkour-fitness/	sports
/articles/ecuador-radiodrama/	arts
/articles/ukraine-crimea/	war-and-peace
/articles/sedentary-health/	health
/articles/brothers-keeper/	law
/articles/jamaica-reggae/	arts
/articles/blackhistory-museum/	law
/articles/oldest-skeleton/	science
/articles/oilpipeline-tribes/	law
/articles/urban-squash/	sports
/articles/college-mentors/	kids
/articles/starfish-disease/	science
/articles/ivory-ban/	law
/articles/venezuela-protests/	war-and-peace
/articles/gambling-procon/	opinion
/articles/giraffe-copenhagen/	kids
/articles/sochi-close/	sports
/articles/mammoth-tusk/	science
/articles/loudmusic-shooting/	law
/articles/ncaa-union/	sports
/articles/red-art/	arts
/articles/norway-skiing/	sports
/articles/ukraine-protests/	war-and-peace
/articles/olympics-dogs/	war-and-peace
/articles/nvschool-uniforms/	kids
/articles/smithsonian-cool/	arts
/articles/white-davis/	sports
/articles/anxiety-teens/	kids
/articles/whoopingcrane-shooting/	law
/articles/israeli-doctor/	war-and-peace
/articles/olympics-cool/	war-and-peace
/articles/soda-warning/	health
/articles/comcast-merger/	money
/articles/women-jumpers/	sports
/articles/border-music/	arts
/articles/mammals-origin/	science
/articles/afghan-women/	war-and-peace
/articles/warmweather-olympians/	sports
/articles/stinkbugs-crops/	science
/articles/plague-genetics/	science
/articles/prehistoric-miami/	arts
/articles/bogota-art/	arts
/articles/ice-princess/	kids
/articles/winter-salt/	money
/articles/slopestyle-risks/	sports
/articles/space-regulation/	law
/articles/orca-lifespan/	science
/articles/utah-lunches/	kids
/articles/whale-beachings/	science
/articles/income-readers/	kids
/articles/royal-budget/	money
/articles/cvs-cigarettes/	health
/articles/sunbelt-snowbelt/	money
/articles/child-labor/	kids
/articles/genetics-future/	health
/articles/obama-wifi/	kids
/articles/poverty-study/	law
/articles/hearst-pool/	money
/articles/snowden-procon/	opinion
/articles/stolen-violin/	arts
/articles/used-electronics/	money
/articles/water-car/	money
/articles/china-newyear/	money
/articles/georgia-storm/	law
/articles/algebra-texas/	kids
/articles/sharks-hawaii/	science
/articles/civilwar-movie/	arts
/articles/kohler-toilets/	health
/articles/obama-address/	law
/articles/angrybirds-spying/	law
/articles/ceres-water/	science
/articles/la-earthquake/	science
/articles/futsal-la/	sports
/articles/tortoise-shells/	science
/articles/aquaponics-farm/	money
/articles/rio-garbage/	money
/articles/bee-virus/	science
/articles/dali-warhol/	arts
/articles/horticulture-crisis/	kids
/articles/kids-diet/	kids
/articles/climate-procon/	opinion
/articles/sochi-olympics/	war-and-peace
/articles/gay-jurors/	law
/articles/california-drought/	law
/articles/spanish-books/	arts
/articles/richest-85/	money
/articles/science-haiku/	science
/articles/foodstamps-doctors/	health
/articles/pharaoh-tomb/	arts
/articles/apple-settlement/	kids
/articles/mentalhealth-screenings/	kids
/articles/sardine-shortage/	science
/articles/amusement-injuries/	kids
/articles/solar-sharks/	science
/articles/obesity-economics/	kids
/articles/chemical-spill/	money
/articles/china-orchestra/	arts
/articles/penguin-dancing/	science
/articles/doctor-shortage/	health
/articles/gadgets-pollution/	science
/articles/library-technology/	kids
/articles/plastic-ocean/	science
/articles/smoking-increase/	health
/articles/school-discipline/	kids
/articles/china-space/	science
/articles/usa-population/	money
/articles/prison-newspaper/	law
/articles/electriccars-procon/	opinion
/articles/la-ipads/	kids
/articles/nasa-whitehouse/	science
/articles/virus-bacteria/	health
/articles/neanderthal-organization/	science
/articles/college-recruiters/	kids
/articles/invasive-fish/	science
/articles/headlice-hysteria/	kids
/articles/rodman-nkorea/	sports
/articles/weather-cold/	science
/articles/grades-homework/	kids
/articles/arizona-immigration/	law
/articles/tribe-marijuana/	law
/articles/lizard-breathing/	science
/articles/business-veterans/	money
/articles/parents-classroom/	kids
/articles/jellyfish-robot/	science
/articles/bears-florida/	science
/articles/gender-gap/	money
/articles/farming-drones/	science
/articles/virtual-surgery/	health
/articles/navy-procon/	opinion
/articles/harsh-parents/	kids
/articles/cats-domesticated/	science
/articles/fed-dollars/	money
/articles/hurricane-ice/	science
/articles/dairyfarm-abuse/	money
/articles/mars-chemicals/	science
/articles/energy-eagles/	science
/articles/syria-snowstorm/	war-and-peace
/articles/affluenza-trial/	money
/articles/sports-concussions/	sports
/articles/ice-fishing/	sports
/articles/plate-collisions/	sports
/articles/pitbull-problem/	law
/articles/moocs-limits/	kids
/articles/neanderthal-dna/	science
/articles/time-popefrancis/	war-and-peace
/articles/college-math/	kids
/articles/online-schools/	kids
/articles/light-pollution/	science
/articles/obama-polling/	law
/articles/magnet-toys/	kids
/articles/politics-whigs/	law
/articles/nsa-gamers/	war-and-peace
/articles/syria-ship/	war-and-peace
/articles/iran-youth/	war-and-peace
/articles/edu-attendance/	kids
/articles/procon-wages/	opinion
/articles/mandela-obit/	war-and-peace
/articles/obama-poverty/	law
/articles/biden-asia/	war-and-peace
/articles/olympic-bobsled/	sports
/articles/physical-literacy/	kids
/articles/farms-data/	science
/articles/amazon-drones/	money
/articles/buddha-shrine/	arts
/articles/lungcancer-awareness/	health
/articles/declining-fitness/	health
/articles/china-moon/	science
/articles/train-derailment/	money
/articles/immigration-protest/	law
/articles/eco-car/	science
/articles/martian-mojave/	science
/articles/turkey-eagle/	kids
/articles/solar-panels/	science
/articles/dinosaur-discovery/	science
/articles/principal-discipline/	kids
/articles/code-breaker/	war-and-peace
/articles/warthog-plane/	war-and-peace
/articles/scottsboro-boys/	law
/articles/china-babyboom/	war-and-peace
/articles/christians-egypt/	war-and-peace
/articles/dogs-pets/	science
/articles/console-wars/	money
/articles/boredom-research/	kids
/articles/digital-giving/	money
/articles/obama-jfk/	war-and-peace
/articles/saving-cursive/	kids
/articles/chinese-students/	kids
/articles/tornado-warnings/	science
/articles/selfdriving-cars/	science
/articles/obama-tribe/	law
/articles/gettysburg-retraction/	war-and-peace
/articles/ocean-acid/	science
/articles/black-hole/	science
/articles/meatless-meat/	science
/articles/black-thursday/	money
/articles/france-school/	kids
/articles/cat-fossils/	science
/articles/bird-flu/	health
/articles/little-libraries/	kids
/articles/british-shipyard/	war-and-peace
/articles/filipino-expats/	money
/articles/linguistics-huh/	science
/articles/tallest-building/	arts
/articles/florida-coral/	science
/articles/dakota-oilboom/	money
/articles/rainbow-loom/	kids
/articles/veterans-day/	war-and-peace
/articles/fda-transfats/	health
/articles/banksy-nyc/	arts
/articles/mcdonalds-menu/	money
/articles/busdriver-religion/	law
/articles/autism-babies/	health
/articles/iron-man/	war-and-peace
/articles/nba-stats/	sports
/articles/teen-tracking/	kids
/articles/germany-art/	arts
/articles/nyc-election/	law
/articles/wolf-fight/	law
/articles/football-bullying/	sports
/articles/rhino-auction/	money
/articles/poor-smoking/	health
/articles/norway-sun/	science
/articles/saudi-men/	law
/articles/dark-matter/	science
/articles/baseball-parade/	sports
/articles/looted-art/	arts
/articles/redskins-controversy/	sports
/articles/roma-discrimination/	war-and-peace
/articles/usa-coleo/	sports
/articles/cornmaze-business/	kids
/articles/curbing-cyberkids/	kids
/articles/ipad-art/	arts
/articles/phone-spying/	war-and-peace
/articles/shopping-discrimination/	law
/articles/healthcare-callcenter/	health
/articles/alberta-oil/	money
/articles/oarfish-mystery/	science
/articles/halloween-sales/	money
/articles/trucker-thieves/	money
/articles/jimthorpe-body/	law
/articles/last-drivein/	money
/articles/military-school/	kids
/articles/cyberbullying-poll/	kids
/articles/wildfire-animals/	science
/articles/cricket-vatican/	war-and-peace
/articles/religion-accommodation/	law
/articles/england-yeti/	science
/articles/asian-art/	arts
/articles/oreo-cocaine/	health
/articles/home-econ/	money
/articles/weapons-asteroids/	war-and-peace
/articles/truck-prices/	money
/articles/shutdown-world/	war-and-peace
/articles/einsteins-brain/	science
/articles/china-gifts/	money
/articles/technology-fashion/	science
/articles/slavery-report/	war-and-peace
/articles/shutdown-deal/	money
/articles/cash-hoarding/	money
/articles/mosquitoes-panama/	science
/articles/saudi-hajj/	health
/articles/poop-pills/	health
/articles/schools-test/	kids
/articles/thanksgiving-hannukah/	kids
/articles/cavemen-recycling/	science
/articles/saudi-drivers/	law
/articles/peace-prize/	war-and-peace
/articles/healthcare-amish/	health
/articles/nobel-literature/	war-and-peace
/articles/age-population/	war-and-peace
/articles/hoax-paper/	science
/articles/latam-moocs/	kids
/articles/food-shutdown/	health
/articles/nobel-physics/	science
/articles/environment-tegulizard/	science
/articles/animated-art/	arts
/articles/tiger-comeback/	money
/articles/nobel-medicine/	health
/articles/mars-curiosity/	science
/articles/politics-debtlimit/	law
/articles/city-farm/	law
/articles/china-society/	kids
/articles/business-cards/	sports
/articles/shutdown-yosemite/	law
/articles/apples-lab/	science
/articles/oil-boom/	money
/articles/disney-lines/	kids
/articles/slavery-reparations/	war-and-peace
/articles/voting-lawsuit/	law
/articles/greatlakes-chemicals/	science
/articles/shutdown-impact/	law
/articles/mcdonalds-sides/	health
/articles/healthcare-law/	health
/articles/athletes-mentalhealth/	sports
/articles/guatemala-textile/	arts
/articles/bionic-leg/	science
/articles/budget-debate/	law
/articles/art-refugees/	arts
/articles/government-shutdown/	law
/articles/whale-earwax/	science
/articles/book-banned/	law
/articles/pakistan-earthquake/	war-and-peace
/articles/falcon-farms/	money
/articles/christian-scouts/	kids
/articles/schools-exercise/	health
/articles/abercrombie-headscarves/	law
/articles/iran-president/	war-and-peace
/articles/latino-business/	money
/articles/china-aviation/	money
/articles/kenya-attack/	war-and-peace
/articles/homecoming-queen/	kids
/articles/ocean-acidification/	science
/articles/chicago-shooting/	law
/articles/insect-gear/	science
/articles/schools-bullying/	kids
/articles/vangogh-painting/	arts
/articles/deportee-videogame/	kids
/articles/brazil-obama/	war-and-peace
/articles/toyoda-obit/	money
/articles/dying-stars/	science
/articles/ship-costaconcordia/	money
/articles/aviation-tooling/	money
/articles/navyyard-shooting/	law
/articles/space-voyager/	science
/articles/urban-transition/	law
/articles/colorado-floods/	science
/articles/syria-deadline/	war-and-peace
/articles/airport-ecosystem/	science
/articles/syria-putin/	war-and-peace
/articles/india-gold/	money
/articles/mexico-soda/	health
/articles/mosquito-drone/	science
/articles/colorado-guns/	law
/articles/chinese-teachers/	kids
/articles/obama-syria/	war-and-peace
/articles/apple-iphone/	money
/articles/football-helmets/	sports
/articles/voting-ID/	law
/articles/yupik-artifacts/	arts
/articles/energydrinks-congress/	health
/articles/deported-migrants/	law
/articles/nasa-moonshot/	science
/articles/alaska-mine/	law
/articles/school-fourday/	kids
/articles/syria-obama/	war-and-peace
/articles/mexico-racism/	law
/articles/mural-ban/	arts
/articles/teen-employment/	money
/articles/syria-refugees/	war-and-peace
/articles/math-violence/	law
/articles/parks-lines/	kids
/articles/native-seeds/	kids
/articles/restaurant-strike/	money
/articles/water-farming/	science
/articles/obama-king/	war-and-peace
/articles/yosemite-fire/	science
/articles/poverty-hike/	kids
/articles/budget-headstart/	money
/articles/syria-inspectors/	war-and-peace
/articles/civilrights-march/	law
/articles/western-fires/	money
/articles/autistic-brains/	kids
/articles/zuckerberg-internet/	money
/articles/mars-meteorites/	science
/articles/manning-sentence/	law
/articles/goldfish-suit/	kids
/articles/tesla-safety/	money
/articles/prison-yoga/	health
/articles/christie-law/	law
/articles/neanderthal-tools/	science
/articles/drone-show/	war-and-peace
/articles/egypt-military/	war-and-peace
/articles/service-dogs/	law
/articles/fruit-breeding/	science
/articles/redwoods-climate/	science
/articles/goat-landscaping/	money
/articles/transportation-hyperloop/	science
/articles/indian-protest/	law
/articles/sinkhole-florida/	science
/articles/hurricane-forecasting/	science
/articles/texting-driving/	kids
/articles/immigrant-release/	law
/articles/ADHD-game/	kids
/articles/holocaust-escape/	war-and-peace
/articles/obama-putin/	war-and-peace
/articles/mlb-steroids/	sports
/articles/black-archaeology/	war-and-peace
/articles/diapers-demand/	money
/articles/embassies-NSA/	war-and-peace
/articles/climate-violence/	science
/articles/fish-bones/	science
/articles/google-balloons/	science
/articles/china-women/	money
/articles/afghan-park/	war-and-peace
/articles/juice-danger/	health
/articles/michelleobama-obesity/	health
/articles/manning-verdict/	war-and-peace
/articles/sharks-sanfrancisco/	science
/articles/frogs-sierras/	science
/articles/dinosaur-teeth/	science
/articles/airforce-topguns/	war-and-peace
/articles/pope-brazil/	war-and-peace
/articles/beef-labeling/	money
/articles/mcdonalds-vietnam/	money
/articles/immigrant-border/	law
/articles/china-elderly/	law
/articles/horses-roundup/	money
/articles/olympic-boycott/	sports
/articles/florida-boycott/	law
/articles/colombia-horses/	law
/articles/asiana-safety/	science
/articles/cambodian-deportees/	law
/articles/mandela-birthday/	war-and-peace
/articles/zimmerman-holder/	law
/articles/glacier-remains/	science
/articles/woodrat-colony/	science
/articles/trex-discovery/	science
/articles/manufacturing-3d/	money
/articles/britain-currency/	money
/articles/zimmerman-verdict/	law
/articles/china-pollution/	science